#HEADER:ProvinceCode,ProvinceName,KabupatenCode,KabupatenName,KecamatanCode,KecamatanName,PrabowoHattaVotes,JokowiKallaVotes,TotalVotes
1,ACEH,2,ACEH SELATAN,248,KOTA BAHAGIA,1172,1389,2561
1,ACEH,2,ACEH SELATAN,222,LABUHAN HAJI BARAT,3584,3200,6784
1,ACEH,2,ACEH SELATAN,3,BAKONGAN,0,0,0
1,ACEH,2,ACEH SELATAN,236,LABUHAN HAJI TIMUR,0,0,0
1,ACEH,2,ACEH SELATAN,204,KLUET TIMUR,2552,1689,4241
1,ACEH,2,ACEH SELATAN,182,BAKONGAN TIMUR,1027,1230,2257
1,ACEH,2,ACEH SELATAN,190,KLUET TENGAH,0,0,0
1,ACEH,2,ACEH SELATAN,161,PASIE RAJA,3470,2925,6395
1,ACEH,2,ACEH SELATAN,212,TRUMON TIMUR,0,0,0
1,ACEH,2,ACEH SELATAN,29,KLUET SELATAN,2779,3259,6038
1,ACEH,2,ACEH SELATAN,116,SAWANG,4676,2743,7419
1,ACEH,2,ACEH SELATAN,47,LABUHAN HAJI,0,0,0
1,ACEH,2,ACEH SELATAN,87,SAMADUA,6333,2476,8809
1,ACEH,2,ACEH SELATAN,132,TAPAKTUAN,7752,3401,11153
1,ACEH,2,ACEH SELATAN,148,TRUMON,950,1174,2124
1,ACEH,269,ACEH TENGGARA,613,LAWE SUMUR,0,0,0
1,ACEH,2,ACEH SELATAN,64,MEUKEK,5016,3676,8692
1,ACEH,2,ACEH SELATAN,259,TRUMON TENGAH,0,0,0
1,ACEH,269,ACEH TENGGARA,632,TANOH ALAS,1398,881,2279
1,ACEH,269,ACEH TENGGARA,270,LAWE ALAS,7473,2030,9503
1,ACEH,269,ACEH TENGGARA,536,BABUL RAHMAH,0,0,0
1,ACEH,269,ACEH TENGGARA,590,DELENG POKHKISEN,0,0,0
1,ACEH,269,ACEH TENGGARA,438,DARUL HASANAH,0,0,0
1,ACEH,269,ACEH TENGGARA,397,BADAR,0,0,0
1,ACEH,269,ACEH TENGGARA,335,BAMBEL,7774,2528,10302
1,ACEH,2,ACEH SELATAN,9,KLUET UTARA,5194,5108,10302
1,ACEH,269,ACEH TENGGARA,516,SEMADAM,0,0,0
1,ACEH,671,ACEH TIMUR,672,DARUL AMAN,2354,3297,5651
1,ACEH,269,ACEH TENGGARA,492,BUKIT TUSAM,0,0,0
1,ACEH,269,ACEH TENGGARA,564,KETAMBE,3705,2347,6052
1,ACEH,269,ACEH TENGGARA,647,LEUSER,0,0,0
1,ACEH,269,ACEH TENGGARA,369,BABUSSALAM,0,0,0
1,ACEH,671,ACEH TIMUR,1063,BANDA ALAM,960,1731,2691
1,ACEH,269,ACEH TENGGARA,467,LAWE BULAN,6165,2590,8755
1,ACEH,269,ACEH TENGGARA,416,BABUL MAKMUR,0,0,0
1,ACEH,671,ACEH TIMUR,1158,DARUL IHSAN,1155,1195,2350
1,ACEH,671,ACEH TIMUR,1080,PEUDAWA,1637,1673,3310
1,ACEH,671,ACEH TIMUR,1098,PEUREULAK TIMUR,1391,2678,4069
1,ACEH,671,ACEH TIMUR,1187,IDI TIMUR,824,1153,1977
1,ACEH,671,ACEH TIMUR,1037,IDI TUNONG,1746,1748,3494
1,ACEH,671,ACEH TIMUR,1175,DARUL FALAH,442,1084,1526
1,ACEH,671,ACEH TIMUR,1135,SUNGAI RAYA,1477,1872,3349
1,ACEH,671,ACEH TIMUR,820,SERBAJADI,1893,1267,3160
1,ACEH,671,ACEH TIMUR,718,JULOK,3589,4736,8325
1,ACEH,671,ACEH TIMUR,1119,PEUREULAK BARAT,2282,2048,4330
1,ACEH,671,ACEH TIMUR,1149,SIMPANG JERNIH,1300,544,1844
1,ACEH,671,ACEH TIMUR,996,MADAT,3393,3941,7334
1,ACEH,671,ACEH TIMUR,948,RANTAU PEUREULAK,5339,3238,8577
1,ACEH,671,ACEH TIMUR,792,BIREM BAYEUN,8471,3382,11853
1,ACEH,671,ACEH TIMUR,909,RANTAU SELAMAT,1835,1942,3777
1,ACEH,671,ACEH TIMUR,756,IDI RAYEUK,5577,5106,10683
1,ACEH,671,ACEH TIMUR,870,PEUREULAK,4870,6850,11720
1,ACEH,671,ACEH TIMUR,1023,INDRA MAKMU,4063,1733,5796
1,ACEH,671,ACEH TIMUR,972,PANTE BIDARI,2626,4052,6678
1,ACEH,1207,ACEH TENGAH,1440,KUTE PANANG,1463,2745,4208
1,ACEH,671,ACEH TIMUR,1201,PEUNARON,2315,1801,4116
1,ACEH,1207,ACEH TENGAH,1386,JAGONG JEGET,3274,1968,5242
1,ACEH,671,ACEH TIMUR,924,SIMPANG ULIM,2492,2775,5267
1,ACEH,1207,ACEH TENGAH,1295,BIES,1865,2243,4108
1,ACEH,1207,ACEH TENGAH,1459,CELALA,1747,3106,4853
1,ACEH,671,ACEH TIMUR,838,NURUSSALAM,2570,3702,6272
1,ACEH,1207,ACEH TENGAH,1307,RUSIP ANTARA,1525,2194,3719
1,ACEH,1207,ACEH TENGAH,1394,KETOL,3311,3819,7130
1,ACEH,1207,ACEH TENGAH,1476,LAUT TAWAR,3987,5035,9022
1,ACEH,1207,ACEH TENGAH,1322,ATU LINTANG,1972,1413,3385
1,ACEH,1207,ACEH TENGAH,1208,LINGE,2239,3127,5366
1,ACEH,1207,ACEH TENGAH,1267,BEBESEN,6936,9334,16270
1,ACEH,1207,ACEH TENGAH,1420,KEBAYAKAN,3047,4750,7797
1,ACEH,1492,ACEH BARAT,1493,JOHAN PAHWALAN,13649,10052,23701
1,ACEH,1492,ACEH BARAT,1778,WOYLA TIMUR,1345,1281,2626
1,ACEH,1207,ACEH TENGAH,1233,SILIH NARA,4403,7420,11823
1,ACEH,1207,ACEH TENGAH,1362,BINTANG,1225,4038,5263
1,ACEH,1207,ACEH TENGAH,1332,PEGASING,3528,6690,10218
1,ACEH,1492,ACEH BARAT,1515,KAWAY XVI,5921,4506,10427
1,ACEH,1492,ACEH BARAT,1726,MEUREUBO,5705,5686,11391
1,ACEH,1492,ACEH BARAT,1621,SAMATIGA,3904,4284,8188
1,ACEH,1492,ACEH BARAT,1654,BUBON,1732,1800,3532
1,ACEH,1492,ACEH BARAT,1577,WOYLA,4000,3208,7208
1,ACEH,1492,ACEH BARAT,1804,PANTON REU,1930,1100,3030
1,ACEH,1492,ACEH BARAT,1700,PANTE CEUREUMEN,3245,2270,5515
1,ACEH,1824,ACEH BESAR,2391,BAITUSSALAM,3779,3160,6939
1,ACEH,1492,ACEH BARAT,1753,WOYLA BARAT,2425,1714,4139
1,ACEH,1824,ACEH BESAR,1825,LHOONG,2779,2419,5198
1,ACEH,1824,ACEH BESAR,2357,SIMPANG TIGA,1857,1176,3033
1,ACEH,1492,ACEH BARAT,1672,ARONGAN LAMBALEK,2261,3316,5577
1,ACEH,1824,ACEH BESAR,1936,SEULIMEUM,4693,5158,9851
1,ACEH,1824,ACEH BESAR,2341,KUTA MALAKA,2158,1042,3200
1,ACEH,1824,ACEH BESAR,2418,LEUPUNG,631,763,1394
1,ACEH,1824,ACEH BESAR,2185,KUTA BARO,6132,5241,11373
1,ACEH,1824,ACEH BESAR,2233,DARUSSALAM,5537,3722,9259
1,ACEH,1824,ACEH BESAR,2263,PULO ACEH,1127,1301,2428
1,ACEH,1824,ACEH BESAR,2263,PULO ACEH,1127,1301,2428
1,ACEH,1492,ACEH BARAT,1559,SUNGAI MAS,1218,845,2063
1,ACEH,1824,ACEH BESAR,2263,PULO ACEH,1127,1301,2428
1,ACEH,1492,ACEH BARAT,1559,SUNGAI MAS,1218,845,2063
1,ACEH,1824,ACEH BESAR,2308,KOTA COT GLIE,3272,3379,6651
1,ACEH,1824,ACEH BESAR,2294,KOTA JANTHO,1967,2018,3985
1,ACEH,1824,ACEH BESAR,2376,DARUL KAMAL,1819,1599,3418
1,ACEH,1824,ACEH BESAR,1883,INDRAPURI,6377,3906,10283
1,ACEH,1824,ACEH BESAR,2093,PEUKAN BADA,3778,3662,7440
1,ACEH,1824,ACEH BESAR,1854,LHOKNGA,4580,3111,7691
1,ACEH,2452,PIDIE,3081,KEUMALA,1032,2969,4001
1,ACEH,1824,ACEH BESAR,2024,SUKAMAKMUR,4189,3170,7359
1,ACEH,2452,PIDIE,2929,SAKTI,0,0,0
1,ACEH,1824,ACEH BESAR,1984,MONTASIK,6373,3074,9447
1,ACEH,1824,ACEH BESAR,2425,BLANG BINTANG,3053,2148,5201
1,ACEH,2452,PIDIE,2453,BATEE,0,0,0
1,ACEH,2452,PIDIE,3164,MANE,976,1397,2373
1,ACEH,2452,PIDIE,3032,TANGSE,5198,6186,11384
1,ACEH,2452,PIDIE,3099,MUTIARA TIMUR,4938,8418,13356
1,ACEH,2452,PIDIE,2864,PIDIE,0,0,0
1,ACEH,1824,ACEH BESAR,2060,DARUL IMARAH,11484,7981,19465
1,ACEH,1824,ACEH BESAR,2120,MESJID RAYA,3001,3257,6258
1,ACEH,2452,PIDIE,2680,MILA,1760,1958,3718
1,ACEH,2452,PIDIE,2979,SIMPANG TIGA,4660,5611,10271
1,ACEH,1824,ACEH BESAR,2134,INGIN JAYA,8026,6351,14377
1,ACEH,2452,PIDIE,2482,DELIMA,0,0,0
1,ACEH,2452,PIDIE,2618,KEMBANG TANJONG,3411,5241,8652
1,ACEH,2452,PIDIE,3169,GLUMPANG BARO,1565,2941,4506
1,ACEH,3205,ACEH UTARA,3206,BAKTIYA,7176,6433,13609
1,ACEH,2452,PIDIE,2664,KOTA SIGLI,3518,3742,7260
1,ACEH,2452,PIDIE,2815,PEUKAN BARO,0,0,0
1,ACEH,3205,ACEH UTARA,3943,PAYA BAKONG,2984,2449,5433
1,ACEH,2452,PIDIE,2527,GEUMPANG,785,1158,1943
1,ACEH,2452,PIDIE,3191,TITEUE,1110,1353,2463
1,ACEH,2452,PIDIE,2720,MUTIARA,3270,4973,8243
1,ACEH,3205,ACEH UTARA,3916,BAKTIYA BARAT,2948,3224,6172
1,ACEH,2452,PIDIE,2701,MUARA TIGA,4865,1867,6732
1,ACEH,3205,ACEH UTARA,3837,NISAM,4535,1928,6463
1,ACEH,3205,ACEH UTARA,3867,COT GIREK,6352,2450,8802
1,ACEH,3205,ACEH UTARA,4004,SIMPANG KRAMAT,2801,1284,4085
1,ACEH,2452,PIDIE,2568,INDRA JAYA,3618,5734,9352
1,ACEH,3205,ACEH UTARA,4057,GEUREDONG PASE,1563,533,2096
1,ACEH,2452,PIDIE,2750,PADANG TIJI,4002,5167,9169
1,ACEH,2452,PIDIE,2533,GEULUMPANG TIGA,0,0,0
1,ACEH,3205,ACEH UTARA,3892,LANGKAHAN,4194,3819,8013
1,ACEH,3205,ACEH UTARA,3983,NIBONG,2514,1675,4189
1,ACEH,3205,ACEH UTARA,3730,TANAH PASIR,1867,1427,3294
1,ACEH,3205,ACEH UTARA,4069,BANDA BARO,1705,695,2400
1,ACEH,3205,ACEH UTARA,4021,LAPANG,1181,1280,2461
1,ACEH,3205,ACEH UTARA,3472,MEURAH MULIA,3965,3782,7747
1,ACEH,3205,ACEH UTARA,3447,MUARA BATU,5837,2986,8823
1,ACEH,3205,ACEH UTARA,3797,SAWANG,7866,3931,11797
1,ACEH,3205,ACEH UTARA,4033,PIRAK TIMUR,1775,1507,3282
1,ACEH,3205,ACEH UTARA,3264,DEWANTARA,8254,4449,12703
1,ACEH,3205,ACEH UTARA,3598,SYAMTALIRA ARON,4374,3121,7495
1,ACEH,3205,ACEH UTARA,3320,LHOKSUKON,9549,7667,17216
1,ACEH,3205,ACEH UTARA,3397,MATANGKULI,3872,3445,7317
1,ACEH,3205,ACEH UTARA,3523,SAMUDERA,6294,3771,10065
1,ACEH,3205,ACEH UTARA,4079,NISAM ANTARA,1611,937,2548
1,ACEH,4086,SIMEULUE,4178,TELUK DALAM,0,0,0
1,ACEH,4233,ACEH SINGKIL,4355,KUALA BARU,569,413,982
1,ACEH,3205,ACEH UTARA,3564,SEUNUDDON,6338,2800,9138
1,ACEH,4086,SIMEULUE,4129,TEUPAH BARAT,0,0,0
1,ACEH,3205,ACEH UTARA,3672,TANAH LUAS,6213,4120,10333
1,ACEH,4086,SIMEULUE,4204,TEUPAH SELATAN,0,0,0
1,ACEH,4086,SIMEULUE,4087,SIMEULUE TENGAH,0,0,0
1,ACEH,4086,SIMEULUE,83455,TEUPAH TENGAH,0,0,0
1,ACEH,4086,SIMEULUE,4112,SALANG,0,0,0
1,ACEH,3205,ACEH UTARA,3280,KUTA MAKMUR,6314,3703,10017
1,ACEH,4086,SIMEULUE,4224,ALAPAN,0,0,0
1,ACEH,3205,ACEH UTARA,3633,SYAMTALIRA BAYU,4800,2801,7601
1,ACEH,4233,ACEH SINGKIL,4348,SINGKOHOR,1795,1135,2930
1,ACEH,4086,SIMEULUE,4148,SIMEULUE TIMUR,0,0,0
1,ACEH,4086,SIMEULUE,4189,SIMEULUE BARAT,0,0,0
1,ACEH,4086,SIMEULUE,83456,SIMEULUE CUT,0,0,0
1,ACEH,4362,BIREUEN,4925,PEUSANGAN SELATAN,3085,2060,5145
1,ACEH,4233,ACEH SINGKIL,4285,GUNUNG MERIAH,9059,5549,14608
1,ACEH,4233,ACEH SINGKIL,4311,KOTA BAHARU,1627,1031,2658
1,ACEH,4233,ACEH SINGKIL,4336,SURO MAKMUR,1233,1698,2931
1,ACEH,4233,ACEH SINGKIL,4360,PULAU BANYAK BARAT,370,654,1024
1,ACEH,4233,ACEH SINGKIL,4234,PULAU BANYAK,838,574,1412
1,ACEH,4362,BIREUEN,4709,JULI,7180,4581,11761
1,ACEH,4362,BIREUEN,4793,SIMPANG MAMPLAM,4639,4356,8995
1,ACEH,4233,ACEH SINGKIL,4329,DANAU PARIS,1054,1273,2327
1,ACEH,4233,ACEH SINGKIL,4242,SIMPANG KANAN,3821,2613,6434
1,ACEH,4233,ACEH SINGKIL,4321,SINGKIL UTARA,2008,1810,3818
1,ACEH,4233,ACEH SINGKIL,4268,SINGKIL,4907,2480,7387
1,ACEH,4362,BIREUEN,4620,MAKMUR,3523,2013,5536
1,ACEH,4362,BIREUEN,4858,KOTA JUANG,10759,5952,16711
1,ACEH,4362,BIREUEN,4363,SAMALANGA,6185,3652,9837
1,ACEH,4989,ACEH BARAT DAYA,5027,MANGGENG,3479,2648,6127
1,ACEH,4362,BIREUEN,4689,PANDRAH,2018,1335,3353
1,ACEH,4362,BIREUEN,4746,JANGKA,5432,4381,9813
1,ACEH,4989,ACEH BARAT DAYA,5104,LEMBAH SABIL,0,0,0
1,ACEH,4362,BIREUEN,4882,KUALA,4215,2235,6450
1,ACEH,4362,BIREUEN,4903,PEUSANGAN SIBLAH KRUENG,2839,1838,4677
1,ACEH,4362,BIREUEN,4835,PEULIMBANG,2180,2342,4522
1,ACEH,4989,ACEH BARAT DAYA,5093,BABAH ROT,2284,3615,5899
1,ACEH,4362,BIREUEN,4410,JEUNIEB,7878,3096,10974
1,ACEH,4362,BIREUEN,4454,PEUDADA,5264,5031,10295
1,ACEH,4989,ACEH BARAT DAYA,5045,SUSOH,4895,5305,10200
1,ACEH,4362,BIREUEN,4648,GANDAPURA,6515,2592,9107
1,ACEH,5138,GAYO LUES,5244,PUTERI BETUNG,1259,2673,3932
1,ACEH,4989,ACEH BARAT DAYA,5074,KUALA BATEE,3972,3536,7508
1,ACEH,4989,ACEH BARAT DAYA,4990,BLANG PIDIE,4780,3709,8489
1,ACEH,5138,GAYO LUES,5254,BLANGJERANGO,1201,2483,3684
1,ACEH,4362,BIREUEN,4507,JEUMPA,7113,4486,11599
1,ACEH,4362,BIREUEN,4947,KUTA BLANG,5773,2745,8518
1,ACEH,4362,BIREUEN,4550,PEUSANGAN,11179,7392,18571
1,ACEH,5138,GAYO LUES,5139,KUTAPANJANG,1536,2498,4034
1,ACEH,5286,ACEH JAYA,5342,SETIA BAKTI,1729,1593,3322
1,ACEH,5286,ACEH JAYA,5324,KRUENG SABEE,0,0,0
1,ACEH,5138,GAYO LUES,5221,DABUN GELANG,1233,1499,2732
1,ACEH,5138,GAYO LUES,5265,PANTAN CUACA,714,1561,2275
1,ACEH,4989,ACEH BARAT DAYA,5127,JEUMPA,2860,1536,4396
1,ACEH,5286,ACEH JAYA,5287,TEUNOM,3345,3199,6544
1,ACEH,4989,ACEH BARAT DAYA,5118,SETIA,1239,1627,2866
1,ACEH,5463,NAGAN RAYA,83454,TRIPA MAKMUR,1932,1612,3544
1,ACEH,5286,ACEH JAYA,5394,JAYA,5321,2147,7468
1,ACEH,5463,NAGAN RAYA,5671,TADU RAYA,3129,3235,6364
1,ACEH,5138,GAYO LUES,5275,TERIPE JAYA,0,0,0
1,ACEH,5286,ACEH JAYA,83452,DARUL HIKMAH,1779,1271,3050
1,ACEH,5286,ACEH JAYA,5443,PANGA,1458,1992,3450
1,ACEH,5138,GAYO LUES,5231,BLANGPEGAYON,1155,1465,2620
1,ACEH,5286,ACEH JAYA,83451,INDRA JAYA,2307,1233,3540
1,ACEH,5463,NAGAN RAYA,5552,BEUTONG,2308,4007,6315
1,ACEH,5138,GAYO LUES,5152,BLANGKEJEREN,0,0,0
1,ACEH,5286,ACEH JAYA,5356,SAMPOINIET,1453,1618,3071
1,ACEH,5138,GAYO LUES,5173,RIKIT GAIB,0,0,0
1,ACEH,5138,GAYO LUES,5211,PINING,680,1444,2124
1,ACEH,5463,NAGAN RAYA,5464,KUALA,4447,4269,8716
1,ACEH,5286,ACEH JAYA,83453,PASIE RAYA,0,0,0
1,ACEH,5463,NAGAN RAYA,5654,KUALA PESISIR,4204,3819,8023
1,ACEH,5463,NAGAN RAYA,83457,BEUTONG ATEUH BANGGALANG,308,553,861
1,ACEH,5694,ACEH TAMIANG,5829,KEJURUAN MUDA,9005,5757,14762
1,ACEH,5138,GAYO LUES,5187,TERANGUN,2187,2268,4455
1,ACEH,5463,NAGAN RAYA,5581,DARUL MAKMUR,10555,9416,19971
1,ACEH,5463,NAGAN RAYA,5581,DARUL MAKMUR,10555,9416,19971
1,ACEH,5694,ACEH TAMIANG,5823,KOTA KUALASIMPANG,4391,2982,7373
1,ACEH,5463,NAGAN RAYA,5581,DARUL MAKMUR,10555,9416,19971
1,ACEH,5694,ACEH TAMIANG,5823,KOTA KUALASIMPANG,4391,2982,7373
1,ACEH,5694,ACEH TAMIANG,5872,BANDA MULIA,3180,1373,4553
1,ACEH,5463,NAGAN RAYA,5581,DARUL MAKMUR,10555,9416,19971
1,ACEH,5694,ACEH TAMIANG,5823,KOTA KUALASIMPANG,4391,2982,7373
1,ACEH,5694,ACEH TAMIANG,5872,BANDA MULIA,3180,1373,4553
1,ACEH,5694,ACEH TAMIANG,5883,BANDAR PUSAKA,3303,2136,5439
1,ACEH,5463,NAGAN RAYA,5581,DARUL MAKMUR,10555,9416,19971
1,ACEH,5694,ACEH TAMIANG,5823,KOTA KUALASIMPANG,4391,2982,7373
1,ACEH,5694,ACEH TAMIANG,5872,BANDA MULIA,3180,1373,4553
1,ACEH,5694,ACEH TAMIANG,5883,BANDAR PUSAKA,3303,2136,5439
1,ACEH,5463,NAGAN RAYA,5517,SEUNAGAN TIMUR,3125,4321,7446
1,ACEH,5463,NAGAN RAYA,5581,DARUL MAKMUR,10555,9416,19971
1,ACEH,5694,ACEH TAMIANG,5823,KOTA KUALASIMPANG,4391,2982,7373
1,ACEH,5694,ACEH TAMIANG,5872,BANDA MULIA,3180,1373,4553
1,ACEH,5694,ACEH TAMIANG,5883,BANDAR PUSAKA,3303,2136,5439
1,ACEH,5463,NAGAN RAYA,5517,SEUNAGAN TIMUR,3125,4321,7446
1,ACEH,5463,NAGAN RAYA,5634,SUKA MAKMUE,2077,2852,4929
1,ACEH,5463,NAGAN RAYA,5581,DARUL MAKMUR,10555,9416,19971
1,ACEH,5694,ACEH TAMIANG,5823,KOTA KUALASIMPANG,4391,2982,7373
1,ACEH,5694,ACEH TAMIANG,5872,BANDA MULIA,3180,1373,4553
1,ACEH,5694,ACEH TAMIANG,5883,BANDAR PUSAKA,3303,2136,5439
1,ACEH,5463,NAGAN RAYA,5517,SEUNAGAN TIMUR,3125,4321,7446
1,ACEH,5463,NAGAN RAYA,5634,SUKA MAKMUE,2077,2852,4929
1,ACEH,5920,BENER MERIAH,5921,TIMANG GAJAH,0,0,0
1,ACEH,5694,ACEH TAMIANG,5845,TAMIANG HULU,5532,2790,8322
1,ACEH,5920,BENER MERIAH,5952,PINTU RIME GAYO,1965,3742,5707
1,ACEH,5694,ACEH TAMIANG,5766,KARANG BARU,12432,5320,17752
1,ACEH,5463,NAGAN RAYA,5482,SEUNAGAN,3480,4764,8244
1,ACEH,5694,ACEH TAMIANG,5695,MANYAK PAYED,7261,4187,11448
1,ACEH,5694,ACEH TAMIANG,5899,TENGGULUN,3867,2994,6861
1,ACEH,5694,ACEH TAMIANG,5798,SERUWAY,6817,4801,11618
1,ACEH,5920,BENER MERIAH,6139,MESIDAH,635,1445,2080
1,ACEH,5920,BENER MERIAH,6098,PERMATA,0,0,0
1,ACEH,5920,BENER MERIAH,6045,BANDAR,0,0,0
1,ACEH,5920,BENER MERIAH,6126,BENER KELIPAH,759,1531,2290
1,ACEH,5920,BENER MERIAH,5976,BUKIT,0,0,0
1,ACEH,5920,BENER MERIAH,6017,WIH PESAM,5304,5670,10974
1,ACEH,5694,ACEH TAMIANG,5855,RANTAU,10874,4766,15640
1,ACEH,6166,PIDIE JAYA,6294,MEURAH DUA,2344,2740,5084
1,ACEH,5920,BENER MERIAH,6081,SYIAH UTAMA,300,653,953
1,ACEH,5694,ACEH TAMIANG,5905,SEKERAK,1990,1106,3096
1,ACEH,6166,PIDIE JAYA,6369,TRIENGGADENG,3869,4105,7974
1,ACEH,6166,PIDIE JAYA,6358,PANTERAJA,1521,1300,2821
1,ACEH,5694,ACEH TAMIANG,5732,BENDAHARA,5617,2931,8548
1,ACEH,6397,KOTA BANDA ACEH,6459,KUTA RAJA,1716,1702,3418
1,ACEH,5920,BENER MERIAH,6155,GAJAH PUTIH,0,0,0
1,ACEH,6397,KOTA BANDA ACEH,6398,BAITURRAHMAN,6679,5261,11940
1,ACEH,6166,PIDIE JAYA,6167,MEUREUDU,3636,4771,8407
1,ACEH,6166,PIDIE JAYA,6229,JANGKA BUYA,1195,2071,3266
1,ACEH,6397,KOTA BANDA ACEH,6409,KUTA ALAM,8282,6568,14850
1,ACEH,6166,PIDIE JAYA,6198,ULIM,1917,3794,5711
1,ACEH,6397,KOTA BANDA ACEH,6466,BANDA RAYA,5642,3709,9351
1,ACEH,6497,KOTA SABANG,6498,SUKAKARYA,3555,2918,6473
1,ACEH,6497,KOTA SABANG,6507,SUKAJAYA,3746,2619,6365
1,ACEH,6591,KOTA LANGSA,6592,LANGSA TIMUR,3639,1838,5477
1,ACEH,6518,KOTA LHOKSEUMAWE,6579,MUARA SATU,5999,3257,9256
1,ACEH,6166,PIDIE JAYA,6248,BANDAR DUA,3590,4847,8437
1,ACEH,6591,KOTA LANGSA,6628,LANGSA LAMA,9313,3508,12821
1,ACEH,6518,KOTA LHOKSEUMAWE,6537,BANDA SAKTI,14892,8317,23209
1,ACEH,6397,KOTA BANDA ACEH,6438,SYIAH KUALA,6280,4618,10898
1,ACEH,6591,KOTA LANGSA,6638,LANGSA BARO,14232,5092,19324
1,ACEH,6166,PIDIE JAYA,6314,BANDAR BARU,6010,6710,12720
1,ACEH,6591,KOTA LANGSA,6617,LANGSA KOTA,8533,4667,13200
1,ACEH,6397,KOTA BANDA ACEH,6487,ULEE KARENG,5028,3950,8978
1,ACEH,6648,KOTA SUBULUSSALAM,6675,RUNDENG,3764,1685,5449
1,ACEH,6397,KOTA BANDA ACEH,6477,JAYA BARU,4594,3471,8065
1,ACEH,6397,KOTA BANDA ACEH,6421,MEURAXA,3215,3080,6295
1,ACEH,6591,KOTA LANGSA,6607,LANGSA BARAT,6976,3235,10211
1,ACEH,6648,KOTA SUBULUSSALAM,6699,SULTAN DAULAT,3649,2204,5853
1,ACEH,6397,KOTA BANDA ACEH,6449,LUENG BATA,4387,3644,8031
6728,SUMATERA UTARA,7240,TAPANULI TENGAH,7411,BARUS UTARA,240,2040,2280
6728,SUMATERA UTARA,7240,TAPANULI TENGAH,7402,PASARIBU TOBING,0,0,0
1,ACEH,6648,KOTA SUBULUSSALAM,6649,SIMPANG KIRI,7966,4310,12276
6728,SUMATERA UTARA,7240,TAPANULI TENGAH,7392,BADIRI,2631,6471,9102
6728,SUMATERA UTARA,7240,TAPANULI TENGAH,7255,SORKAM,0,0,0
1,ACEH,6518,KOTA LHOKSEUMAWE,6519,MUARA DUA,9299,4709,14008
1,ACEH,6648,KOTA SUBULUSSALAM,6717,LONGKIB,1494,1039,2533
1,ACEH,6518,KOTA LHOKSEUMAWE,6556,BLANG MANGAT,4426,3013,7439
6728,SUMATERA UTARA,7240,TAPANULI TENGAH,7425,LUMUT,992,3857,4849
1,ACEH,6648,KOTA SUBULUSSALAM,6664,PENANGGALAN,3299,2038,5337
6728,SUMATERA UTARA,7240,TAPANULI TENGAH,7322,SIBABANGUN,2050,5479,7529
6728,SUMATERA UTARA,7240,TAPANULI TENGAH,7418,SUKA BANGUN,340,1114,1454
6728,SUMATERA UTARA,7240,TAPANULI TENGAH,7281,PINANGSORI,2315,6550,8865
6728,SUMATERA UTARA,7240,TAPANULI TENGAH,7376,SITAHUIS,0,0,0
6728,SUMATERA UTARA,7240,TAPANULI TENGAH,7383,TUKKA,1587,3496,5083
6728,SUMATERA UTARA,7240,TAPANULI TENGAH,7289,MANDUAMAS,1828,5877,7705
6728,SUMATERA UTARA,7240,TAPANULI TENGAH,7340,SORKAM BARAT,2183,4574,6757
6728,SUMATERA UTARA,7240,TAPANULI TENGAH,7352,SIRANDORUNG,1010,4761,5771
6728,SUMATERA UTARA,7240,TAPANULI TENGAH,7361,ANDAM DEWI,1407,4863,6270
6728,SUMATERA UTARA,7438,TAPANULI UTARA,7439,TARUTUNG,2140,16837,18977
6728,SUMATERA UTARA,7240,TAPANULI TENGAH,7330,SOSOR GADONG,0,0,0
6728,SUMATERA UTARA,7240,TAPANULI TENGAH,7312,TAPIAN NAULI,2000,6211,8211
6728,SUMATERA UTARA,7240,TAPANULI TENGAH,7432,SARUDIK,0,0,0
6728,SUMATERA UTARA,7240,TAPANULI TENGAH,7241,BARUS,3972,2833,6805
6728,SUMATERA UTARA,7438,TAPANULI UTARA,7534,PAHAE JAE,821,4304,5125
6728,SUMATERA UTARA,7438,TAPANULI UTARA,7514,PAHAE JULU,586,5306,5892
6728,SUMATERA UTARA,7438,TAPANULI UTARA,7668,GAROGA,914,6395,7309
6728,SUMATERA UTARA,7438,TAPANULI UTARA,7499,SIPOHOLON,936,9178,10114
6728,SUMATERA UTARA,7240,TAPANULI TENGAH,7271,PANDAN,0,0,0
6728,SUMATERA UTARA,7438,TAPANULI UTARA,7548,SIMANGUMBAN,677,2716,3393
6728,SUMATERA UTARA,7697,TAPANULI SELATAN,7921,MUARA BATANG TORU,2141,2946,5087
6728,SUMATERA UTARA,7240,TAPANULI TENGAH,7299,KOLANG,1291,6367,7658
6728,SUMATERA UTARA,7438,TAPANULI UTARA,7606,PARMONANGAN,303,6447,6750
6728,SUMATERA UTARA,7438,TAPANULI UTARA,7591,PAGARAN,308,7648,7956
6728,SUMATERA UTARA,7438,TAPANULI UTARA,7621,SIPAHUTAR,706,10962,11668
6728,SUMATERA UTARA,7438,TAPANULI UTARA,7645,PANGARIBUAN,929,11370,12299
6728,SUMATERA UTARA,7438,TAPANULI UTARA,7681,MUARA,229,6506,6735
6728,SUMATERA UTARA,7697,TAPANULI SELATAN,7827,BATANG ANGKOLA,11997,3672,15669
6728,SUMATERA UTARA,7438,TAPANULI UTARA,7484,ADIAN KOTING,518,5878,6396
6728,SUMATERA UTARA,7438,TAPANULI UTARA,7471,SIATAS BARITA,664,5661,6325
6728,SUMATERA UTARA,7697,TAPANULI SELATAN,7713,BATANG TORU,7160,7530,14690
6728,SUMATERA UTARA,7697,TAPANULI SELATAN,7698,ANGKOLA BARAT,8823,2362,11185
6728,SUMATERA UTARA,7960,NIAS,8082,ULUGAWO,486,4785,5271
6728,SUMATERA UTARA,7438,TAPANULI UTARA,7557,PURBA TUA,482,2920,3402
6728,SUMATERA UTARA,7960,NIAS,7961,HILIDUHO,222,4117,4339
6728,SUMATERA UTARA,7697,TAPANULI SELATAN,7737,ANGKOLA TIMUR,8052,1963,10015
6728,SUMATERA UTARA,7697,TAPANULI SELATAN,7949,ANGKOLA SANGKUNUR,3871,5876,9747
6728,SUMATERA UTARA,7697,TAPANULI SELATAN,7888,SAYUR MATINGGI,7994,3401,11395
6728,SUMATERA UTARA,7960,NIAS,8056,HILISERANGKAI,427,5891,6318
6728,SUMATERA UTARA,7697,TAPANULI SELATAN,7753,SIPIROK,11369,4333,15702
6728,SUMATERA UTARA,7697,TAPANULI SELATAN,7864,ARSE,2975,1570,4545
6728,SUMATERA UTARA,8094,LANGKAT,8095,BAHOROK,0,0,0
6728,SUMATERA UTARA,7697,TAPANULI SELATAN,7931,TANO TOMBANGAN ANGKOLA,1431,6247,7678
6728,SUMATERA UTARA,7697,TAPANULI SELATAN,7794,SAIPAR DOLOK HOLE,4687,2178,6865
6728,SUMATERA UTARA,7697,TAPANULI SELATAN,7908,AEK BILAH,2908,975,3883
6728,SUMATERA UTARA,7960,NIAS,8001,IDANO GAWO,2099,9244,11343
6728,SUMATERA UTARA,8094,LANGKAT,8368,SAWIT SEBERANG,5258,7260,12518
6728,SUMATERA UTARA,7697,TAPANULI SELATAN,7875,MARANCAR,3491,1451,4942
6728,SUMATERA UTARA,7960,NIAS,8069,BOTOMUZOI,387,3819,4206
6728,SUMATERA UTARA,7697,TAPANULI SELATAN,7809,ANGKOLA SELATAN,5712,6129,11841
6728,SUMATERA UTARA,7960,NIAS,7975,GIDO,517,8501,9018
6728,SUMATERA UTARA,8094,LANGKAT,8350,BRANDAN BARAT,0,0,0
6728,SUMATERA UTARA,8094,LANGKAT,8151,SEI BINGEI,8473,14775,23248
6728,SUMATERA UTARA,8094,LANGKAT,8115,SALAPIAN,5536,8311,13847
6728,SUMATERA UTARA,8094,LANGKAT,8274,PADANG TUALANG,11242,12489,23731
6728,SUMATERA UTARA,8094,LANGKAT,8302,BABALAN,12053,12274,24327
6728,SUMATERA UTARA,7960,NIAS,8020,BAWOLATO,1524,7707,9231
6728,SUMATERA UTARA,8094,LANGKAT,8334,SEI LEPAN,9688,12619,22307
6728,SUMATERA UTARA,8094,LANGKAT,8254,TANJUNG PURA,0,0,0
6728,SUMATERA UTARA,8094,LANGKAT,8387,KUTAMBARU,2173,4877,7050
6728,SUMATERA UTARA,8094,LANGKAT,8323,BESITANG,0,0,0
6728,SUMATERA UTARA,8094,LANGKAT,8289,GEBANG,10299,9860,20159
6728,SUMATERA UTARA,8094,LANGKAT,8358,BATANG SERANGAN,0,0,0
6728,SUMATERA UTARA,8094,LANGKAT,8376,SIRAPIT,4312,4443,8755
6728,SUMATERA UTARA,8094,LANGKAT,8311,PANGKALAN SUSU,0,0,0
6728,SUMATERA UTARA,8408,KARO,8620,KUTABULUH,1330,5130,6460
6728,SUMATERA UTARA,8094,LANGKAT,8220,SECANGGANG,17900,14641,32541
6728,SUMATERA UTARA,8094,LANGKAT,8398,PEMATANG JAYA,0,0,0
6728,SUMATERA UTARA,8408,KARO,8655,NAMAN TERAN,986,4123,5109
6728,SUMATERA UTARA,8094,LANGKAT,8133,KUALA,11025,9508,20533
6728,SUMATERA UTARA,8408,KARO,8637,DOLAT RAYAT,483,3606,4089
6728,SUMATERA UTARA,8094,LANGKAT,8191,STABAT,0,0,0
6728,SUMATERA UTARA,8094,LANGKAT,8204,WAMPU,11793,9067,20860
6728,SUMATERA UTARA,8094,LANGKAT,8240,HINAI,0,0,0
6728,SUMATERA UTARA,8094,LANGKAT,8176,SELESAI,0,0,0
6728,SUMATERA UTARA,8408,KARO,8453,TIGAPANAH,1593,13036,14629
6728,SUMATERA UTARA,8094,LANGKAT,8168,BINJAI,13548,8475,22023
6728,SUMATERA UTARA,8408,KARO,8602,SIMPANG EMPAT,1356,8141,9497
6728,SUMATERA UTARA,8408,KARO,8409,KABANJAHE,5367,21660,27027
6728,SUMATERA UTARA,8408,KARO,8544,TIGABINANGA,1594,8804,10398
6728,SUMATERA UTARA,8408,KARO,8519,JUHAR,651,6993,7644
6728,SUMATERA UTARA,8688,DELI SERDANG,8973,SUNGGAL,0,0,0
6728,SUMATERA UTARA,8408,KARO,8476,MEREK,854,8271,9125
6728,SUMATERA UTARA,8688,DELI SERDANG,9012,LABUHAN DELI,0,0,0
6728,SUMATERA UTARA,8408,KARO,8593,PAYUNG,667,4816,5483
6728,SUMATERA UTARA,8688,DELI SERDANG,8689,GUNUNG MERIAH,0,0,0
6728,SUMATERA UTARA,8688,DELI SERDANG,8991,HAMPARAN PERAK,44699,23338,68037
6728,SUMATERA UTARA,8688,DELI SERDANG,9051,LUBUK PAKAM,0,0,0
6728,SUMATERA UTARA,8408,KARO,8645,MERDEKA,1105,5109,6214
6728,SUMATERA UTARA,8408,KARO,8564,LAUBALENG,929,7498,8427
6728,SUMATERA UTARA,8408,KARO,8496,MUNTE,1389,8829,10218
6728,SUMATERA UTARA,8688,DELI SERDANG,9082,PANTAI LABU,10445,8143,18588
6728,SUMATERA UTARA,8688,DELI SERDANG,9018,PERCUT SEI TUAN,91428,62678,154106
6728,SUMATERA UTARA,8408,KARO,8580,MARDINGDING,735,7003,7738
6728,SUMATERA UTARA,8688,DELI SERDANG,8957,PATUMBAK,0,0,0
6728,SUMATERA UTARA,8408,KARO,8670,TIGANDERKET,1097,5880,6977
6728,SUMATERA UTARA,8688,DELI SERDANG,8936,STM HULU,1225,5003,6228
6728,SUMATERA UTARA,8408,KARO,8433,BARUSJAHE,1115,10680,11795
6728,SUMATERA UTARA,8688,DELI SERDANG,9039,BATANG KUIS,16245,8625,24870
6728,SUMATERA UTARA,8408,KARO,8423,BERASTAGI,4211,14167,18378
6728,SUMATERA UTARA,8688,DELI SERDANG,8801,NAMORAMBE,0,0,0
6728,SUMATERA UTARA,8688,DELI SERDANG,9065,PAGAR MERBAU,10146,7753,17899
6728,SUMATERA UTARA,8688,DELI SERDANG,8966,DELI TUA,0,0,0
6728,SUMATERA UTARA,8688,DELI SERDANG,8729,SIBOLANGIT,0,0,0
6728,SUMATERA UTARA,8688,DELI SERDANG,8856,STM HILIR,4465,10386,14851
6728,SUMATERA UTARA,9114,SIMALUNGUN,9407,SILIMAKUTA,626,5254,5880
6728,SUMATERA UTARA,8688,DELI SERDANG,8702,TANJUNG MORAWA,0,0,0
6728,SUMATERA UTARA,8688,DELI SERDANG,8775,PANCUR BATU,14120,24919,39039
6728,SUMATERA UTARA,9114,SIMALUNGUN,9340,JAWA MARAJA BAH JAMBI,4883,5400,10283
6728,SUMATERA UTARA,9114,SIMALUNGUN,9326,HUTA BAYU RAJA,3696,10975,14671
6728,SUMATERA UTARA,8688,DELI SERDANG,8760,KUTALIMBARU,0,0,0
6728,SUMATERA UTARA,8688,DELI SERDANG,8906,GALANG,0,0,0
6728,SUMATERA UTARA,9114,SIMALUNGUN,9424,SILOU KAHEAN,2095,6009,8104
6728,SUMATERA UTARA,9114,SIMALUNGUN,9414,DOLOK SILAU,850,6301,7151
6728,SUMATERA UTARA,9114,SIMALUNGUN,9372,BANDAR HULUAN,6467,6922,13389
6728,SUMATERA UTARA,9114,SIMALUNGUN,9310,DOLOK BATU NANGGAR,11047,10255,21302
6728,SUMATERA UTARA,9114,SIMALUNGUN,9349,DOLOK PARDAMEAN,515,7822,8337
6728,SUMATERA UTARA,9114,SIMALUNGUN,9470,UJUNG PADANG,8424,11708,20132
6728,SUMATERA UTARA,8688,DELI SERDANG,8872,BANGUN PURBA,4991,6222,11213
6728,SUMATERA UTARA,9114,SIMALUNGUN,9397,BANDAR MASILAM,6559,5814,12373
6728,SUMATERA UTARA,8688,DELI SERDANG,9102,BERINGIN,12254,13808,26062
6728,SUMATERA UTARA,9114,SIMALUNGUN,9160,PANEI,2220,9457,11677
6728,SUMATERA UTARA,9114,SIMALUNGUN,9360,PEMATANG BANDAR,6474,9134,15608
6728,SUMATERA UTARA,9114,SIMALUNGUN,9192,RAYA KAHEAN,2269,6713,8982
6728,SUMATERA UTARA,9114,SIMALUNGUN,9115,SIANTAR,12917,19726,32643
6728,SUMATERA UTARA,9114,SIMALUNGUN,9441,TAPIAN DOLOK,9783,10642,20425
6728,SUMATERA UTARA,9114,SIMALUNGUN,9150,GUNUNG MALIGAS,7665,5511,13176
6728,SUMATERA UTARA,9114,SIMALUNGUN,9382,BANDAR,13056,16782,29838
6728,SUMATERA UTARA,9114,SIMALUNGUN,9304,GIRSANG SIPANGAN BOLON,860,7009,7869
6728,SUMATERA UTARA,9114,SIMALUNGUN,9276,DOLOK PANRIBUAN,865,8446,9311
6728,SUMATERA UTARA,9114,SIMALUNGUN,9204,BOSAR MALIGAS,8701,11264,19965
6728,SUMATERA UTARA,9114,SIMALUNGUN,9133,GUNUNG MALELA,8780,9304,18084
6728,SUMATERA UTARA,9114,SIMALUNGUN,9234,PEMATANG SIDAMANIK,1896,6648,8544
6728,SUMATERA UTARA,9114,SIMALUNGUN,9172,PANOMBEIAN PANE,3068,7582,10650
6728,SUMATERA UTARA,9114,SIMALUNGUN,9452,RAYA,2199,13824,16023
6728,SUMATERA UTARA,9114,SIMALUNGUN,9298,HARANGGAOL HORISON,222,2690,2912
6728,SUMATERA UTARA,9497,ASAHAN,9641,RAHUNING,4415,4765,9180
6728,SUMATERA UTARA,9497,ASAHAN,9641,RAHUNING,4415,4765,9180
6728,SUMATERA UTARA,9114,SIMALUNGUN,9182,JORLANG HATARAN,1949,6265,8214
6728,SUMATERA UTARA,9114,SIMALUNGUN,9287,PURBA,1039,9521,10560
6728,SUMATERA UTARA,9497,ASAHAN,9687,SILAU LAUT,4445,5187,9632
6728,SUMATERA UTARA,9497,ASAHAN,9498,MERANTI,3218,6662,9880
6728,SUMATERA UTARA,9497,ASAHAN,9660,SEI KEPAYANG BARAT,2862,2225,5087
6728,SUMATERA UTARA,9497,ASAHAN,9660,SEI KEPAYANG BARAT,2862,2225,5087
6728,SUMATERA UTARA,9497,ASAHAN,9667,SEI KEPAYANG TIMUR,2391,1179,3570
6728,SUMATERA UTARA,9497,ASAHAN,9660,SEI KEPAYANG BARAT,2862,2225,5087
6728,SUMATERA UTARA,9497,ASAHAN,9667,SEI KEPAYANG TIMUR,2391,1179,3570
6728,SUMATERA UTARA,9497,ASAHAN,9681,SETIA JANJI,2826,3921,6747
6728,SUMATERA UTARA,9497,ASAHAN,9660,SEI KEPAYANG BARAT,2862,2225,5087
6728,SUMATERA UTARA,9497,ASAHAN,9667,SEI KEPAYANG TIMUR,2391,1179,3570
6728,SUMATERA UTARA,9497,ASAHAN,9681,SETIA JANJI,2826,3921,6747
6728,SUMATERA UTARA,9114,SIMALUNGUN,9245,TANAH JAWA,8933,16027,24960
6728,SUMATERA UTARA,9497,ASAHAN,9660,SEI KEPAYANG BARAT,2862,2225,5087
6728,SUMATERA UTARA,9497,ASAHAN,9667,SEI KEPAYANG TIMUR,2391,1179,3570
6728,SUMATERA UTARA,9497,ASAHAN,9681,SETIA JANJI,2826,3921,6747
6728,SUMATERA UTARA,9114,SIMALUNGUN,9245,TANAH JAWA,8933,16027,24960
6728,SUMATERA UTARA,9114,SIMALUNGUN,9220,SIDAMANIK,3902,10164,14066
6728,SUMATERA UTARA,9497,ASAHAN,9660,SEI KEPAYANG BARAT,2862,2225,5087
6728,SUMATERA UTARA,9497,ASAHAN,9667,SEI KEPAYANG TIMUR,2391,1179,3570
6728,SUMATERA UTARA,9497,ASAHAN,9681,SETIA JANJI,2826,3921,6747
6728,SUMATERA UTARA,9114,SIMALUNGUN,9245,TANAH JAWA,8933,16027,24960
6728,SUMATERA UTARA,9114,SIMALUNGUN,9220,SIDAMANIK,3902,10164,14066
6728,SUMATERA UTARA,9497,ASAHAN,9649,SEI DADAP,7438,7839,15277
6728,SUMATERA UTARA,9497,ASAHAN,9660,SEI KEPAYANG BARAT,2862,2225,5087
6728,SUMATERA UTARA,9497,ASAHAN,9667,SEI KEPAYANG TIMUR,2391,1179,3570
6728,SUMATERA UTARA,9497,ASAHAN,9681,SETIA JANJI,2826,3921,6747
6728,SUMATERA UTARA,9114,SIMALUNGUN,9245,TANAH JAWA,8933,16027,24960
6728,SUMATERA UTARA,9114,SIMALUNGUN,9220,SIDAMANIK,3902,10164,14066
6728,SUMATERA UTARA,9497,ASAHAN,9649,SEI DADAP,7438,7839,15277
6728,SUMATERA UTARA,9497,ASAHAN,9712,TELUK DALAM,4211,4397,8608
6728,SUMATERA UTARA,9497,ASAHAN,9660,SEI KEPAYANG BARAT,2862,2225,5087
6728,SUMATERA UTARA,9497,ASAHAN,9667,SEI KEPAYANG TIMUR,2391,1179,3570
6728,SUMATERA UTARA,9497,ASAHAN,9681,SETIA JANJI,2826,3921,6747
6728,SUMATERA UTARA,9114,SIMALUNGUN,9245,TANAH JAWA,8933,16027,24960
6728,SUMATERA UTARA,9114,SIMALUNGUN,9220,SIDAMANIK,3902,10164,14066
6728,SUMATERA UTARA,9497,ASAHAN,9649,SEI DADAP,7438,7839,15277
6728,SUMATERA UTARA,9497,ASAHAN,9712,TELUK DALAM,4211,4397,8608
6728,SUMATERA UTARA,9497,ASAHAN,9631,AEK SONGSONGAN,3259,5662,8921
6728,SUMATERA UTARA,9497,ASAHAN,9660,SEI KEPAYANG BARAT,2862,2225,5087
6728,SUMATERA UTARA,9497,ASAHAN,9667,SEI KEPAYANG TIMUR,2391,1179,3570
6728,SUMATERA UTARA,9497,ASAHAN,9681,SETIA JANJI,2826,3921,6747
6728,SUMATERA UTARA,9114,SIMALUNGUN,9245,TANAH JAWA,8933,16027,24960
6728,SUMATERA UTARA,9114,SIMALUNGUN,9220,SIDAMANIK,3902,10164,14066
6728,SUMATERA UTARA,9497,ASAHAN,9649,SEI DADAP,7438,7839,15277
6728,SUMATERA UTARA,9497,ASAHAN,9712,TELUK DALAM,4211,4397,8608
6728,SUMATERA UTARA,9497,ASAHAN,9631,AEK SONGSONGAN,3259,5662,8921
6728,SUMATERA UTARA,9114,SIMALUNGUN,9266,HATONDUHAN,2079,8167,10246
6728,SUMATERA UTARA,9497,ASAHAN,9660,SEI KEPAYANG BARAT,2862,2225,5087
6728,SUMATERA UTARA,9497,ASAHAN,9667,SEI KEPAYANG TIMUR,2391,1179,3570
6728,SUMATERA UTARA,9497,ASAHAN,9681,SETIA JANJI,2826,3921,6747
6728,SUMATERA UTARA,9114,SIMALUNGUN,9245,TANAH JAWA,8933,16027,24960
6728,SUMATERA UTARA,9114,SIMALUNGUN,9220,SIDAMANIK,3902,10164,14066
6728,SUMATERA UTARA,9497,ASAHAN,9649,SEI DADAP,7438,7839,15277
6728,SUMATERA UTARA,9497,ASAHAN,9712,TELUK DALAM,4211,4397,8608
6728,SUMATERA UTARA,9497,ASAHAN,9631,AEK SONGSONGAN,3259,5662,8921
6728,SUMATERA UTARA,9114,SIMALUNGUN,9266,HATONDUHAN,2079,8167,10246
6728,SUMATERA UTARA,9114,SIMALUNGUN,9488,PAMATANG SILIMA HUTA,323,5053,5376
6728,SUMATERA UTARA,9497,ASAHAN,9660,SEI KEPAYANG BARAT,2862,2225,5087
6728,SUMATERA UTARA,9497,ASAHAN,9667,SEI KEPAYANG TIMUR,2391,1179,3570
6728,SUMATERA UTARA,9497,ASAHAN,9681,SETIA JANJI,2826,3921,6747
6728,SUMATERA UTARA,9114,SIMALUNGUN,9245,TANAH JAWA,8933,16027,24960
6728,SUMATERA UTARA,9114,SIMALUNGUN,9220,SIDAMANIK,3902,10164,14066
6728,SUMATERA UTARA,9497,ASAHAN,9649,SEI DADAP,7438,7839,15277
6728,SUMATERA UTARA,9497,ASAHAN,9712,TELUK DALAM,4211,4397,8608
6728,SUMATERA UTARA,9497,ASAHAN,9631,AEK SONGSONGAN,3259,5662,8921
6728,SUMATERA UTARA,9114,SIMALUNGUN,9266,HATONDUHAN,2079,8167,10246
6728,SUMATERA UTARA,9114,SIMALUNGUN,9488,PAMATANG SILIMA HUTA,323,5053,5376
6728,SUMATERA UTARA,9497,ASAHAN,9701,PULO BANDRING,7239,8182,15421
6728,SUMATERA UTARA,9497,ASAHAN,9506,AIR JOMAN,9421,11402,20823
6728,SUMATERA UTARA,9497,ASAHAN,9673,TINGGI RAJA,4582,5487,10069
6728,SUMATERA UTARA,9497,ASAHAN,9693,RAWANG PANCA ARGA,4490,4739,9229
6728,SUMATERA UTARA,9497,ASAHAN,9604,KOTA KISARAN BARAT,16480,12068,28548
6728,SUMATERA UTARA,9727,LABUHANBATU,9739,RANTAU SELATAN,19295,9890,29185
6728,SUMATERA UTARA,9727,LABUHANBATU,9749,BILAH BARAT,10276,6125,16401
6728,SUMATERA UTARA,9497,ASAHAN,9618,KOTA KISARAN TIMUR,20541,14396,34937
6728,SUMATERA UTARA,9727,LABUHANBATU,9760,BILAH HILIR,10740,13104,23844
6728,SUMATERA UTARA,9727,LABUHANBATU,9760,BILAH HILIR,10740,13104,23844
6728,SUMATERA UTARA,9497,ASAHAN,9586,BANDAR PASIR MANDOGE,4857,11593,16450
6728,SUMATERA UTARA,9727,LABUHANBATU,9760,BILAH HILIR,10740,13104,23844
6728,SUMATERA UTARA,9497,ASAHAN,9586,BANDAR PASIR MANDOGE,4857,11593,16450
6728,SUMATERA UTARA,9497,ASAHAN,9565,BANDAR PULAU,4477,6895,11372
6728,SUMATERA UTARA,9497,ASAHAN,9576,BUNTU PANE,4976,7425,12401
6728,SUMATERA UTARA,9497,ASAHAN,9539,AIR BATU,9790,9766,19556
6728,SUMATERA UTARA,9727,LABUHANBATU,9728,RANTAU UTARA,24400,16271,40671
6728,SUMATERA UTARA,9497,ASAHAN,9552,PULAU RAKYAT,6746,9180,15926
6728,SUMATERA UTARA,9497,ASAHAN,9596,AEK KUASAN,4761,7872,12633
6728,SUMATERA UTARA,9497,ASAHAN,9530,SIMPANG EMPAT,7103,10817,17920
6728,SUMATERA UTARA,9497,ASAHAN,9719,AEK LEDONG,3824,6019,9843
6728,SUMATERA UTARA,9497,ASAHAN,9523,SEI KEPAYANG,2956,4231,7187
6728,SUMATERA UTARA,9727,LABUHANBATU,9818,PANAI HILIR,6461,7671,14132
6728,SUMATERA UTARA,9497,ASAHAN,9514,TANJUNG BALAI,7629,5422,13051
6728,SUMATERA UTARA,9835,DAIRI,9984,LAE PARIRA,1210,5601,6811
6728,SUMATERA UTARA,9835,DAIRI,9883,SIEMPAT NEMPU,1109,7533,8642
6728,SUMATERA UTARA,9835,DAIRI,9972,PARBULUAN,805,8640,9445
6728,SUMATERA UTARA,9727,LABUHANBATU,9799,PANGKATAN,7165,9523,16688
6728,SUMATERA UTARA,9727,LABUHANBATU,9807,PANAI TENGAH,5368,8405,13773
6728,SUMATERA UTARA,9835,DAIRI,9897,SILIMA PUNGGA PUNGA,1240,5235,6475
6728,SUMATERA UTARA,9835,DAIRI,9947,SIEMPAT NEMPU HILIR,730,4521,5251
6728,SUMATERA UTARA,9727,LABUHANBATU,9774,BILAH HULU,15414,13143,28557
6728,SUMATERA UTARA,9835,DAIRI,9836,SIDIKALANG,5185,17072,22257
6728,SUMATERA UTARA,9835,DAIRI,9958,PEGAGAN HILIR,905,6282,7187
6728,SUMATERA UTARA,10020,TOBA SAMOSIR,10213,SIANTAR NARUMONDA,300,2563,2863
6728,SUMATERA UTARA,9835,DAIRI,10009,SILAHISABUNGAN,200,2090,2290
6728,SUMATERA UTARA,9727,LABUHANBATU,9827,PANAI HULU,7452,7769,15221
6728,SUMATERA UTARA,9835,DAIRI,9914,TANAH PINEM,1809,9164,10973
6728,SUMATERA UTARA,9835,DAIRI,9868,TIGALINGGA,1728,9860,11588
6728,SUMATERA UTARA,10020,TOBA SAMOSIR,10200,NASSAU,617,3259,3876
6728,SUMATERA UTARA,9835,DAIRI,9934,SIEMPAT NEMPU HULU,2251,6313,8564
6728,SUMATERA UTARA,10020,TOBA SAMOSIR,10113,BORBOR,208,3139,3347
6728,SUMATERA UTARA,9835,DAIRI,9848,SUMBUL,1797,16966,18763
6728,SUMATERA UTARA,9835,DAIRI,10015,SITINJO,1038,4314,5352
6728,SUMATERA UTARA,10020,TOBA SAMOSIR,10147,AJIBATA,191,3686,3877
6728,SUMATERA UTARA,10020,TOBA SAMOSIR,10120,PORSEA,758,5734,6492
6728,SUMATERA UTARA,10020,TOBA SAMOSIR,10206,TAMPAHAN,134,1971,2105
6728,SUMATERA UTARA,9835,DAIRI,10003,BRAMPU,1314,2208,3522
6728,SUMATERA UTARA,9835,DAIRI,9994,GUNUNG SITEMBER,804,3933,4737
6728,SUMATERA UTARA,10020,TOBA SAMOSIR,10091,HABINSARAN,636,6951,7587
6728,SUMATERA UTARA,10020,TOBA SAMOSIR,10173,ULUAN,297,3850,4147
6728,SUMATERA UTARA,10020,TOBA SAMOSIR,83409,PARMAKSIAN,762,4203,4965
6728,SUMATERA UTARA,10020,TOBA SAMOSIR,10157,LUMBAN JULU,242,3990,4232
6728,SUMATERA UTARA,10020,TOBA SAMOSIR,10021,BALIGE,1692,16619,18311
6728,SUMATERA UTARA,10020,TOBA SAMOSIR,83408,BONATUA LUNASI,279,2402,2681
6728,SUMATERA UTARA,10227,MANDAILING NATAL,10569,RANTO BAEK,4376,1664,6040
6728,SUMATERA UTARA,10227,MANDAILING NATAL,10423,ULU PUNGKUT,2232,182,2414
6728,SUMATERA UTARA,10227,MANDAILING NATAL,10453,BATANG NATAL,9102,2683,11785
6728,SUMATERA UTARA,10020,TOBA SAMOSIR,10191,SIGUMPAR,269,3368,3637
6728,SUMATERA UTARA,10020,TOBA SAMOSIR,10055,LAGUBOTI,781,9000,9781
6728,SUMATERA UTARA,10227,MANDAILING NATAL,10623,SINUNUKAN,4297,4290,8587
6728,SUMATERA UTARA,10020,TOBA SAMOSIR,10102,PINTU POHAN MERANTI,574,2485,3059
6728,SUMATERA UTARA,10020,TOBA SAMOSIR,10076,SILAEN,414,6305,6719
6728,SUMATERA UTARA,10227,MANDAILING NATAL,10437,MUARA SIPONGI,3410,1666,5076
6728,SUMATERA UTARA,10227,MANDAILING NATAL,10505,BATAHAN,7227,2751,9978
6728,SUMATERA UTARA,10227,MANDAILING NATAL,10554,MUARA BATANG GADIS,4479,2393,6872
6728,SUMATERA UTARA,10227,MANDAILING NATAL,10614,PAKANTAN,725,370,1095
6728,SUMATERA UTARA,10227,MANDAILING NATAL,10308,PANYABUNGAN BARAT,4153,683,4836
6728,SUMATERA UTARA,10227,MANDAILING NATAL,10485,LINGGA BAYU,6986,4178,11164
6728,SUMATERA UTARA,10227,MANDAILING NATAL,10524,NATAL,8616,5370,13986
6728,SUMATERA UTARA,10227,MANDAILING NATAL,10392,LEMBAH SORIK MARAPI,4566,637,5203
6728,SUMATERA UTARA,10227,MANDAILING NATAL,10638,NAGA JUANG,845,1062,1907
6728,SUMATERA UTARA,10227,MANDAILING NATAL,10228,PANYABUNGAN KOTA,29000,5814,34814
6728,SUMATERA UTARA,10227,MANDAILING NATAL,10228,PANYABUNGAN KOTA,29000,5814,34814
6728,SUMATERA UTARA,10227,MANDAILING NATAL,10602,PUNCAK SORIK MARAPI,3985,299,4284
6728,SUMATERA UTARA,10227,MANDAILING NATAL,10343,BUKIT MALINTANG,3906,1343,5249
6728,SUMATERA UTARA,10227,MANDAILING NATAL,10267,PANYABUNGAN UTARA,6169,2550,8719
6728,SUMATERA UTARA,10227,MANDAILING NATAL,10588,HUTA BARGOT,3140,626,3766
6728,SUMATERA UTARA,10646,NIAS SELATAN,10647,LOLOMATUA,0,0,0
6728,SUMATERA UTARA,10227,MANDAILING NATAL,10280,PANYABUNGAN TIMUR,5181,805,5986
6728,SUMATERA UTARA,10227,MANDAILING NATAL,10280,PANYABUNGAN TIMUR,5181,805,5986
6728,SUMATERA UTARA,10227,MANDAILING NATAL,10402,TAMBANGAN,5476,837,6313
6728,SUMATERA UTARA,10227,MANDAILING NATAL,10280,PANYABUNGAN TIMUR,5181,805,5986
6728,SUMATERA UTARA,10227,MANDAILING NATAL,10402,TAMBANGAN,5476,837,6313
6728,SUMATERA UTARA,10227,MANDAILING NATAL,10296,PANYABUNGAN SELATAN,4475,656,5131
6728,SUMATERA UTARA,10646,NIAS SELATAN,83460,HURUNA,0,0,0
6728,SUMATERA UTARA,10227,MANDAILING NATAL,10355,KOTANOPAN,10802,1950,12752
6728,SUMATERA UTARA,10646,NIAS SELATAN,10823,AMANDRAYA,1376,3881,5257
6728,SUMATERA UTARA,10646,NIAS SELATAN,83464,ULUSUSUA,1720,5107,6827
6728,SUMATERA UTARA,10646,NIAS SELATAN,10887,SUSUA,0,0,0
6728,SUMATERA UTARA,10646,NIAS SELATAN,10963,ARAMO,0,0,0
6728,SUMATERA UTARA,10227,MANDAILING NATAL,10319,SIABU,16900,4237,21137
6728,SUMATERA UTARA,10646,NIAS SELATAN,10929,TOMA,0,0,0
6728,SUMATERA UTARA,10646,NIAS SELATAN,83462,ONOHAZUMBA,0,0,0
6728,SUMATERA UTARA,10646,NIAS SELATAN,83466,SOMAMBAWA,529,4392,4921
6728,SUMATERA UTARA,10646,NIAS SELATAN,11005,FANAYAMA,0,0,0
6728,SUMATERA UTARA,10646,NIAS SELATAN,83467,BORONADU,0,0,0
6728,SUMATERA UTARA,10646,NIAS SELATAN,10917,HILIMEGAI,0,0,0
6728,SUMATERA UTARA,10646,NIAS SELATAN,83468,SIMUK,0,0,0
6728,SUMATERA UTARA,10646,NIAS SELATAN,10674,GOMO,0,0,0
6728,SUMATERA UTARA,10646,NIAS SELATAN,83459,ULUNOYO,0,0,0
6728,SUMATERA UTARA,10646,NIAS SELATAN,10941,MAZINO,1391,5820,7211
6728,SUMATERA UTARA,10646,NIAS SELATAN,10805,TELUK DALAM,1587,16952,18539
6728,SUMATERA UTARA,10646,NIAS SELATAN,10699,LAHUSA,952,10935,11887
6728,SUMATERA UTARA,10646,NIAS SELATAN,10735,HIBALA,0,0,0
6728,SUMATERA UTARA,10646,NIAS SELATAN,10990,MAZO,851,6331,7182
6728,SUMATERA UTARA,10646,NIAS SELATAN,10902,MANIAMOLO,0,0,0
6728,SUMATERA UTARA,10646,NIAS SELATAN,10953,UMBUNASI,0,0,0
6728,SUMATERA UTARA,11022,PAKPAK BHARAT,11034,KERAJAAN,1262,2414,3676
6728,SUMATERA UTARA,11083,HUMBANG HASUNDUTAN,11203,ONAN GANJANG,496,4531,5027
6728,SUMATERA UTARA,11083,HUMBANG HASUNDUTAN,11192,SIJAMAPOLANG,306,2260,2566
6728,SUMATERA UTARA,11022,PAKPAK BHARAT,11045,SALAK,855,2621,3476
6728,SUMATERA UTARA,11022,PAKPAK BHARAT,11064,PAGINDAR,207,346,553
6728,SUMATERA UTARA,11022,PAKPAK BHARAT,11023,SITELU TALI URANG JEHE,2143,1729,3872
6728,SUMATERA UTARA,11022,PAKPAK BHARAT,11052,SITELU TALI URANG JULU,599,1122,1721
6728,SUMATERA UTARA,11083,HUMBANG HASUNDUTAN,11105,POLLUNG,0,0,0
6728,SUMATERA UTARA,10646,NIAS SELATAN,83471,TANAH MASA,0,0,0
6728,SUMATERA UTARA,11083,HUMBANG HASUNDUTAN,11162,DOLOK SANGGUL,0,0,0
6728,SUMATERA UTARA,11022,PAKPAK BHARAT,11076,SIEMPAT RUBE,414,1486,1900
6728,SUMATERA UTARA,11083,HUMBANG HASUNDUTAN,11216,PAKKAT,0,0,0
6728,SUMATERA UTARA,11022,PAKPAK BHARAT,11058,PERGETTENG GETTENG SENGKUT,780,971,1751
6728,SUMATERA UTARA,11247,SAMOSIR,11357,SIMANINDO,479,10367,10846
6728,SUMATERA UTARA,11022,PAKPAK BHARAT,11069,TINADA,421,1386,1807
6728,SUMATERA UTARA,11247,SAMOSIR,11292,NAINGGOLAN,297,5292,5589
6728,SUMATERA UTARA,11247,SAMOSIR,11248,SIANJUR MULA MULA,215,4468,4683
6728,SUMATERA UTARA,11247,SAMOSIR,11279,ONAN RUNGGU,261,4752,5013
6728,SUMATERA UTARA,11247,SAMOSIR,11319,RONGGUR NIHUTA,267,3605,3872
6728,SUMATERA UTARA,11374,SERDANG BEDAGAI,11553,SERBA JADI,4518,5707,10225
6728,SUMATERA UTARA,11247,SAMOSIR,11305,PALIPI,358,7874,8232
6728,SUMATERA UTARA,11083,HUMBANG HASUNDUTAN,11084,PARLILITAN,0,0,0
6728,SUMATERA UTARA,11083,HUMBANG HASUNDUTAN,11139,LINTONG NIHUTA,1419,13138,14557
6728,SUMATERA UTARA,11374,SERDANG BEDAGAI,11604,TEBING SYAHBANDAR,10468,5890,16358
6728,SUMATERA UTARA,11247,SAMOSIR,11328,PANGURURAN,966,13704,14670
6728,SUMATERA UTARA,11374,SERDANG BEDAGAI,11564,TEBING TINGGI,12524,9286,21810
6728,SUMATERA UTARA,11247,SAMOSIR,11260,HARIAN,363,3524,3887
6728,SUMATERA UTARA,11083,HUMBANG HASUNDUTAN,11127,PARANGINAN,0,0,0
6728,SUMATERA UTARA,11083,HUMBANG HASUNDUTAN,11119,BAKTIRAJA,208,3339,3547
6728,SUMATERA UTARA,11374,SERDANG BEDAGAI,11531,KOTARIH,1591,2761,4352
6728,SUMATERA UTARA,11083,HUMBANG HASUNDUTAN,11237,TARABINTANG,0,0,0
6728,SUMATERA UTARA,11374,SERDANG BEDAGAI,11579,PEGAJAHAN,5846,8612,14458
6728,SUMATERA UTARA,11374,SERDANG BEDAGAI,11593,SEI BAMBAN,7063,13952,21015
6728,SUMATERA UTARA,11374,SERDANG BEDAGAI,11457,BANDAR KHALIFAH,4193,7930,12123
6728,SUMATERA UTARA,11374,SERDANG BEDAGAI,11463,DOLOK MERAWAN,5940,3684,9624
6728,SUMATERA UTARA,11635,BATU BARA,11636,MEDANG DERAS,10611,10600,21211
6728,SUMATERA UTARA,11374,SERDANG BEDAGAI,11543,SILINDA,1158,3375,4533
6728,SUMATERA UTARA,11635,BATU BARA,11679,LIMA PULUH,18101,22403,40504
6728,SUMATERA UTARA,11374,SERDANG BEDAGAI,11502,DOLOK MASIHUL,13599,12301,25900
6728,SUMATERA UTARA,11374,SERDANG BEDAGAI,11481,SIPISPIS,7929,8827,16756
6728,SUMATERA UTARA,11635,BATU BARA,11734,SEI BALAI,6451,7252,13703
6728,SUMATERA UTARA,11374,SERDANG BEDAGAI,11448,TANJUNG BERINGIN,7955,7942,15897
6728,SUMATERA UTARA,11635,BATU BARA,11665,AIR PUTIH,11257,12959,24216
6728,SUMATERA UTARA,11374,SERDANG BEDAGAI,11375,PANTAI CERMIN,11276,9103,20379
6728,SUMATERA UTARA,12208,PADANG LAWAS UTARA,12464,PADANG BOLAK JULU,3887,1054,4941
6728,SUMATERA UTARA,12606,PADANG LAWAS,12607,SOSOPAN,3501,1262,4763
6728,SUMATERA UTARA,11635,BATU BARA,11651,SEI SUKA,13961,12921,26882
6728,SUMATERA UTARA,12208,PADANG LAWAS UTARA,12254,DOLOK,9196,2746,11942
6728,SUMATERA UTARA,12208,PADANG LAWAS UTARA,12488,PORTIBI,10348,1955,12303
6728,SUMATERA UTARA,11374,SERDANG BEDAGAI,11388,PERBAUNGAN,28203,21630,49833
6728,SUMATERA UTARA,11374,SERDANG BEDAGAI,11417,TELUK MENGKUDU,9692,9765,19457
6728,SUMATERA UTARA,11635,BATU BARA,11721,TANJUNG TIRAM,10275,13665,23940
6728,SUMATERA UTARA,12606,PADANG LAWAS,12851,SOSA,10863,3981,14844
6728,SUMATERA UTARA,11635,BATU BARA,11707,TALAWI,10748,13683,24431
6728,SUMATERA UTARA,12606,PADANG LAWAS,83407,AEK NABARA BARUMUN,4731,939,5670
6728,SUMATERA UTARA,12208,PADANG LAWAS UTARA,12341,HALONGONAN,10677,5694,16371
6728,SUMATERA UTARA,12208,PADANG LAWAS UTARA,12209,DOLOK SIGOMPULON,5245,2407,7652
6728,SUMATERA UTARA,11374,SERDANG BEDAGAI,11615,BINTANG BAYU,3783,2781,6564
6728,SUMATERA UTARA,12606,PADANG LAWAS,83472,SIHAPAS BARUMUN,2188,432,2620
6728,SUMATERA UTARA,12606,PADANG LAWAS,12736,LUBUK BARUMUN,6099,1660,7759
6728,SUMATERA UTARA,12606,PADANG LAWAS,12761,HUTA RAJA TINGGI,10019,8416,18435
6728,SUMATERA UTARA,12208,PADANG LAWAS UTARA,12527,BATANG ONANG,4184,1640,5824
6728,SUMATERA UTARA,12208,PADANG LAWAS UTARA,12386,PADANG BOLAK,24707,6380,31087
6728,SUMATERA UTARA,12208,PADANG LAWAS UTARA,12595,HULU SIHAPAS,1693,382,2075
6728,SUMATERA UTARA,6729,LABUHANBATU SELATAN,6741,KAMPUNG RAKYAT,12712,14141,26853
6728,SUMATERA UTARA,12208,PADANG LAWAS UTARA,12560,SIMANGAMBAT,12475,13490,25965
6728,SUMATERA UTARA,6729,LABUHANBATU SELATAN,6730,KOTAPINANG,14894,13122,28016
6728,SUMATERA UTARA,6729,LABUHANBATU SELATAN,6782,SILANGKITANG,6988,9008,15996
6728,SUMATERA UTARA,12606,PADANG LAWAS,12809,BARUMUN,15495,4218,19713
6728,SUMATERA UTARA,12606,PADANG LAWAS,83406,BARUMUN SELATAN,2990,710,3700
6728,SUMATERA UTARA,6789,LABUHANBATU UTARA,6790,KUALUH HULU,11924,21298,33222
6728,SUMATERA UTARA,12606,PADANG LAWAS,12891,BATANG LUBU SUTAM,4142,1598,5740
6728,SUMATERA UTARA,6729,LABUHANBATU SELATAN,6772,SUNGAI KANAN,14780,7798,22578
6728,SUMATERA UTARA,6789,LABUHANBATU UTARA,6804,KUALUH LEIDONG,5008,8122,13130
6728,SUMATERA UTARA,12606,PADANG LAWAS,12793,ULU BARUMUN,4212,1738,5950
6728,SUMATERA UTARA,12606,PADANG LAWAS,12708,HURISTAK,5480,2539,8019
6728,SUMATERA UTARA,12606,PADANG LAWAS,12630,BARUMUN TENGAH,7043,1296,8339
6728,SUMATERA UTARA,6789,LABUHANBATU UTARA,6820,AEK KUO,5583,9640,15223
6728,SUMATERA UTARA,6888,NIAS UTARA,6942,ALASA TALUMUZOI,303,2070,2373
6728,SUMATERA UTARA,6789,LABUHANBATU UTARA,6875,KUALUH SELATAN,11146,18706,29852
6728,SUMATERA UTARA,6888,NIAS UTARA,6964,TUGALA OYO,202,2890,3092
6728,SUMATERA UTARA,6729,LABUHANBATU SELATAN,6757,TORGAMBA,17524,29511,47035
6728,SUMATERA UTARA,6789,LABUHANBATU UTARA,6829,MARBAU,11432,9894,21326
6728,SUMATERA UTARA,6888,NIAS UTARA,6923,SITOLU ORI,523,4696,5219
6728,SUMATERA UTARA,6789,LABUHANBATU UTARA,6812,KUALUH HILIR,4649,9288,13937
6728,SUMATERA UTARA,6888,NIAS UTARA,7005,LAHEWA TIMUR,421,3031,3452
6728,SUMATERA UTARA,6888,NIAS UTARA,6983,LAHEWA,1884,6709,8593
6728,SUMATERA UTARA,6888,NIAS UTARA,6889,LOTU,508,4498,5006
6728,SUMATERA UTARA,11743,KOTA MEDAN,11851,MEDAN TEMBUNG,36652,26457,63109
6728,SUMATERA UTARA,6789,LABUHANBATU UTARA,6862,AEK NATAS,7817,7835,15652
6728,SUMATERA UTARA,11743,KOTA MEDAN,11859,MEDAN MAIMUN,12801,9913,22714
6728,SUMATERA UTARA,6888,NIAS UTARA,6973,AFULU,1024,3083,4107
6728,SUMATERA UTARA,7013,NIAS BARAT,7052,MANDREHE BARAT,243,2714,2957
6728,SUMATERA UTARA,7013,NIAS BARAT,7014,LAHOMI,616,4002,4618
6728,SUMATERA UTARA,6888,NIAS UTARA,6949,ALASA,964,5926,6890
6728,SUMATERA UTARA,11743,KOTA MEDAN,11889,MEDAN PETISAH,11954,22355,34309
6728,SUMATERA UTARA,6888,NIAS UTARA,6914,TUHEMBERUA,469,4122,4591
6728,SUMATERA UTARA,6888,NIAS UTARA,6930,NAMOHALU ESIWA,346,4987,5333
6728,SUMATERA UTARA,7013,NIAS BARAT,7026,SIROMBU,1121,3396,4517
6728,SUMATERA UTARA,11743,KOTA MEDAN,11744,MEDAN KOTA,16439,25773,42212
6728,SUMATERA UTARA,11743,KOTA MEDAN,11844,MEDAN LABUHAN,28948,22552,51500
6728,SUMATERA UTARA,11743,KOTA MEDAN,11897,MEDAN TIMUR,28108,28932,57040
6728,SUMATERA UTARA,11743,KOTA MEDAN,11757,MEDAN SUNGGAL,27470,24877,52347
6728,SUMATERA UTARA,6888,NIAS UTARA,6903,SAWO,639,3293,3932
6728,SUMATERA UTARA,7013,NIAS BARAT,7078,MANDREHE,700,8860,9560
6728,SUMATERA UTARA,7013,NIAS BARAT,7112,LOLOFITU MOI,1197,4315,5512
6728,SUMATERA UTARA,11743,KOTA MEDAN,11793,MEDAN TUNTUNGAN,12319,27223,39542
6728,SUMATERA UTARA,11743,KOTA MEDAN,11866,MEDAN POLONIA,11286,12557,23843
6728,SUMATERA UTARA,11743,KOTA MEDAN,11879,MEDAN PERJUANGAN,25497,24598,50095
6728,SUMATERA UTARA,11743,KOTA MEDAN,11779,MEDAN BARAT,19269,20754,40023
6728,SUMATERA UTARA,7013,NIAS BARAT,7099,MANDREHE UTARA,406,3086,3492
6728,SUMATERA UTARA,11743,KOTA MEDAN,11831,MEDAN JOHOR,33926,27539,61465
6728,SUMATERA UTARA,11916,KOTA PEMATANGSIANTAR,11925,SIANTAR BARAT,10327,9058,19385
6728,SUMATERA UTARA,11743,KOTA MEDAN,11909,MEDAN SELAYANG,19764,25578,45342
6728,SUMATERA UTARA,11916,KOTA PEMATANGSIANTAR,11934,SIANTAR UTARA,7902,15791,23693
6728,SUMATERA UTARA,11916,KOTA PEMATANGSIANTAR,11957,SIANTAR MARTOBA,7585,12545,20130
6728,SUMATERA UTARA,11743,KOTA MEDAN,11810,MEDAN AMPLAS,33273,20574,53847
6728,SUMATERA UTARA,11743,KOTA MEDAN,11764,MEDAN HELVETIA,33517,35254,68771
6728,SUMATERA UTARA,11743,KOTA MEDAN,11838,MEDAN MARELAN,39648,20964,60612
6728,SUMATERA UTARA,11743,KOTA MEDAN,11872,MEDAN BARU,6607,12637,19244
6728,SUMATERA UTARA,11743,KOTA MEDAN,11772,MEDAN DENAI,38688,28462,67150
6728,SUMATERA UTARA,11916,KOTA PEMATANGSIANTAR,11942,SIANTAR SELATAN,1181,8265,9446
6728,SUMATERA UTARA,11916,KOTA PEMATANGSIANTAR,11949,SIANTAR MARIHAT,1689,8070,9759
6728,SUMATERA UTARA,11916,KOTA PEMATANGSIANTAR,11971,SIANTAR MARIMBUN,1284,7142,8426
6728,SUMATERA UTARA,11743,KOTA MEDAN,11803,MEDAN BELAWAN,21862,17425,39287
6728,SUMATERA UTARA,11743,KOTA MEDAN,11818,MEDAN AREA,32862,22676,55538
6728,SUMATERA UTARA,11743,KOTA MEDAN,11786,MEDAN DELI,39353,29295,68648
6728,SUMATERA UTARA,11916,KOTA PEMATANGSIANTAR,11965,SIANTAR SITALASARI,5997,7923,13920
6728,SUMATERA UTARA,11978,KOTA SIBOLGA,11995,SIBOLGA SAMBAS,4169,4129,8298
6728,SUMATERA UTARA,11978,KOTA SIBOLGA,11990,SIBOLGA SELATAN,5701,6600,12301
6728,SUMATERA UTARA,12000,KOTA TANJUNG BALAI,12026,DATUK BANDAR,6436,6972,13408
6728,SUMATERA UTARA,12000,KOTA TANJUNG BALAI,12032,DATUK BANDAR TIMUR,7560,4126,11686
6728,SUMATERA UTARA,11978,KOTA SIBOLGA,11985,SIBOLGA KOTA,3161,3866,7027
6728,SUMATERA UTARA,11978,KOTA SIBOLGA,11979,SIBOLGA UTARA,1651,7978,9629
6728,SUMATERA UTARA,11916,KOTA PEMATANGSIANTAR,11917,SIANTAR TIMUR,4159,14493,18652
6728,SUMATERA UTARA,12038,KOTA BINJAI,12049,BINJAI KOTA,8407,7482,15889
6728,SUMATERA UTARA,12038,KOTA BINJAI,12039,BINJAI UTARA,23149,11275,34424
6728,SUMATERA UTARA,12122,KOTA PADANG SIDIMPUAN,12123,PADANGSIDIMPUAN UTARA,24148,5833,29981
6728,SUMATERA UTARA,12122,KOTA PADANG SIDIMPUAN,12169,PADANGSIDIMPUAN HUTAIMBARU,6595,1554,8149
6728,SUMATERA UTARA,12081,KOTA TEBING TINGGI,12098,PADANG HILIR,9204,6888,16092
6728,SUMATERA UTARA,12081,KOTA TEBING TINGGI,12082,PADANG HULU,8165,6273,14438
6728,SUMATERA UTARA,12038,KOTA BINJAI,12057,BINJAI BARAT,12530,7522,20052
6728,SUMATERA UTARA,12038,KOTA BINJAI,12064,BINJAI TIMUR,17748,10030,27778
6728,SUMATERA UTARA,12038,KOTA BINJAI,12072,BINJAI SELATAN,16054,9154,25208
6728,SUMATERA UTARA,12000,KOTA TANJUNG BALAI,12014,SEI TUALANG RASO,5044,3642,8686
6728,SUMATERA UTARA,12000,KOTA TANJUNG BALAI,12008,TANJUNG BALAI UTARA,3523,3551,7074
6728,SUMATERA UTARA,12000,KOTA TANJUNG BALAI,12001,TANJUNG BALAI SELATAN,3993,5131,9124
6728,SUMATERA UTARA,12081,KOTA TEBING TINGGI,12114,TEBING TINGGI KOTA,5861,7338,13199
6728,SUMATERA UTARA,12081,KOTA TEBING TINGGI,12106,BAJENIS,8963,7862,16825
6728,SUMATERA UTARA,12081,KOTA TEBING TINGGI,12090,RAMBUTAN,9399,7137,16536
12920,SUMATERA BARAT,12921,PESISIR SELATAN,83473,AIRPURA,3805,2483,6288
12920,SUMATERA BARAT,12921,PESISIR SELATAN,83474,RANAH AMPEK HULU TAPAN,4143,1864,6007
6728,SUMATERA UTARA,12000,KOTA TANJUNG BALAI,12020,TELUK NIBUNG,7963,5189,13152
6728,SUMATERA UTARA,12122,KOTA PADANG SIDIMPUAN,12153,PADANGSIDIMPUAN BATUNADUA,7548,2276,9824
12920,SUMATERA BARAT,12921,PESISIR SELATAN,12922,PANCUNG SOAL,6917,3211,10128
6728,SUMATERA UTARA,12122,KOTA PADANG SIDIMPUAN,12180,PADANGSIDIMPUAN TENGGARA,9769,3925,13694
12920,SUMATERA BARAT,12921,PESISIR SELATAN,12982,LINGGO SARI BAGANTI,13824,5574,19398
12920,SUMATERA BARAT,12921,PESISIR SELATAN,12977,SUTERA,16484,4997,21481
6728,SUMATERA UTARA,12122,KOTA PADANG SIDIMPUAN,12140,PADANGSIDIMPUAN SELATAN,20957,8884,29841
12920,SUMATERA BARAT,12921,PESISIR SELATAN,13005,IV NAGARI BAYANG UTARA,3711,549,4260
12920,SUMATERA BARAT,12921,PESISIR SELATAN,12996,BASA AMPEK BALAI TAPAN,3384,2180,5564
6728,SUMATERA UTARA,12122,KOTA PADANG SIDIMPUAN,12199,PADANGSIDIMPUAN ANGKOLA JULU,2830,951,3781
6728,SUMATERA UTARA,7132,KOTA GUNUNGSITOLI,7133,GUNUNGSITOLI,6030,20577,26607
12920,SUMATERA BARAT,13010,SOLOK,13011,PANTAI CERMIN,7142,1409,8551
12920,SUMATERA BARAT,12921,PESISIR SELATAN,12964,KOTO XI TARUSAN,16477,5388,21865
12920,SUMATERA BARAT,12921,PESISIR SELATAN,12990,LUNANG,4741,5076,9817
6728,SUMATERA UTARA,7132,KOTA GUNUNGSITOLI,7166,GUNUNGSITOLI SELATAN,535,6019,6554
6728,SUMATERA UTARA,7132,KOTA GUNUNGSITOLI,7182,GUNUNGSITOLI UTARA,1333,6073,7406
12920,SUMATERA BARAT,13010,SOLOK,13055,KUBUNG,23290,3836,27126
12920,SUMATERA BARAT,13010,SOLOK,13083,JUNJUNG SIRI,5220,738,5958
6728,SUMATERA UTARA,7132,KOTA GUNUNGSITOLI,7230,GUNUNGSITOLI BARAT,313,3331,3644
12920,SUMATERA BARAT,12921,PESISIR SELATAN,12952,IV JURAI,17408,5299,22707
6728,SUMATERA UTARA,7132,KOTA GUNUNGSITOLI,7193,GUNUNGSITOLI IDANOI,1153,9868,11021
12920,SUMATERA BARAT,13010,SOLOK,13086,HILIRAN GUMANTI,6056,1149,7205
12920,SUMATERA BARAT,13010,SOLOK,13039,BUKIT SUNDI,9553,1730,11283
12920,SUMATERA BARAT,12921,PESISIR SELATAN,12936,LENGAYANG,16625,7014,23639
12920,SUMATERA BARAT,12921,PESISIR SELATAN,12931,RANAH PESISIR,9987,4188,14175
12920,SUMATERA BARAT,12921,PESISIR SELATAN,12959,BAYANG,16018,3220,19238
12920,SUMATERA BARAT,12921,PESISIR SELATAN,12946,BATANG KAPAS,9918,3763,13681
12920,SUMATERA BARAT,13010,SOLOK,13096,DANAU KEMBAR,7174,746,7920
12920,SUMATERA BARAT,13010,SOLOK,13019,PAYUNG SEKAKI,3587,572,4159
12920,SUMATERA BARAT,13010,SOLOK,13064,X KOTO SINGKARAK,13797,2730,16527
12920,SUMATERA BARAT,13010,SOLOK,13090,TIGO LURAH,3878,910,4788
12920,SUMATERA BARAT,13099,SIJUNJUNG,13108,SIJUNJUNG,16417,4014,20431
12920,SUMATERA BARAT,13099,SIJUNJUNG,13149,SUMPUR KUDUS,7899,3756,11655
12920,SUMATERA BARAT,13099,SIJUNJUNG,13100,TANJUNG GADANG,8787,1879,10666
12920,SUMATERA BARAT,13099,SIJUNJUNG,13118,IV NAGARI,6079,924,7003
12920,SUMATERA BARAT,12921,PESISIR SELATAN,83475,SILAUT,3708,3568,7276
12920,SUMATERA BARAT,13010,SOLOK,13073,X KOTO DIATAS,7811,1579,9390
12920,SUMATERA BARAT,13099,SIJUNJUNG,13124,KAMANG BARU,14311,6826,21137
12920,SUMATERA BARAT,13010,SOLOK,13045,IX KOTO SEI LASI,4366,911,5277
12920,SUMATERA BARAT,13010,SOLOK,13023,LEMBANG JAYA,10038,1668,11706
12920,SUMATERA BARAT,13163,TANAH DATAR,13242,LINTAU BUO UTARA,8652,9698,18350
12920,SUMATERA BARAT,13163,TANAH DATAR,13229,SALIMPAUANG,8057,1692,9749
12920,SUMATERA BARAT,13010,SOLOK,13030,GUNUNG TALANG,19944,3412,23356
12920,SUMATERA BARAT,13010,SOLOK,13014,LEMBAH GUMANTI,19286,2441,21727
12920,SUMATERA BARAT,13163,TANAH DATAR,13200,LINTAU BUO,5338,3689,9027
12920,SUMATERA BARAT,13163,TANAH DATAR,13239,TANJUANG BARU,5799,948,6747
12920,SUMATERA BARAT,13163,TANAH DATAR,13222,PARIANGAN,7683,1711,9394
12920,SUMATERA BARAT,13163,TANAH DATAR,13195,TANJUNG EMAS,9512,2338,11850
12920,SUMATERA BARAT,13099,SIJUNJUNG,13136,LUBUAK TAROK,4601,2626,7227
12920,SUMATERA BARAT,13163,TANAH DATAR,13248,BATIPUAH SELATAN,5057,822,5879
12920,SUMATERA BARAT,13163,TANAH DATAR,13211,SUNGAI TARAB,11803,2642,14445
12920,SUMATERA BARAT,13163,TANAH DATAR,13164,X KOTO,14816,3437,18253
12920,SUMATERA BARAT,13099,SIJUNJUNG,13143,KOTO VII,11768,3037,14805
12920,SUMATERA BARAT,13163,TANAH DATAR,13205,SUNGAYANG,6180,2312,8492
12920,SUMATERA BARAT,13099,SIJUNJUNG,13158,KUPITAN,4641,1234,5875
12920,SUMATERA BARAT,13163,TANAH DATAR,13183,RAMBATAN,13817,2801,16618
12920,SUMATERA BARAT,13163,TANAH DATAR,13174,BATIPUH,10613,2865,13478
12920,SUMATERA BARAT,13253,PADANG PARIAMAN,13285,IV KOTO AUR MALINTANG,6398,1674,8072
12920,SUMATERA BARAT,13253,PADANG PARIAMAN,13297,BATANG GASAN,4503,811,5314
12920,SUMATERA BARAT,13163,TANAH DATAR,13189,LIMA KAUM,15118,3139,18257
12920,SUMATERA BARAT,13163,TANAH DATAR,13236,PADANG GANTING,4988,2093,7081
12920,SUMATERA BARAT,13253,PADANG PARIAMAN,13304,2 X 11 ENAM LINGKUNG,5922,2390,8312
12920,SUMATERA BARAT,13317,AGAM,13318,TANJUNG MUTIARA,0,0,0
12920,SUMATERA BARAT,13253,PADANG PARIAMAN,13276,V KOTO KAMPUNG DALAM,8863,1924,10787
12920,SUMATERA BARAT,13253,PADANG PARIAMAN,13254,LUBUK ALUNG,14807,3443,18250
12920,SUMATERA BARAT,13253,PADANG PARIAMAN,13311,ENAM LINGKUNG,7414,1835,9249
12920,SUMATERA BARAT,13253,PADANG PARIAMAN,13279,SUNGAI GARINGGING,8524,3051,11575
12920,SUMATERA BARAT,13253,PADANG PARIAMAN,13300,V KOTO TIMUR,5615,1130,6745
12920,SUMATERA BARAT,13253,PADANG PARIAMAN,13282,SUNGAI LIMAU,10420,2269,12689
12920,SUMATERA BARAT,13253,PADANG PARIAMAN,13290,SINTUAK TOBOH GADANG,6880,1660,8540
12920,SUMATERA BARAT,13317,AGAM,13361,IV ANGKAT CANDUNG,15606,3746,19352
12920,SUMATERA BARAT,13253,PADANG PARIAMAN,13293,PADANG SAGO,3017,1001,4018
12920,SUMATERA BARAT,13253,PADANG PARIAMAN,13308,PATAMUAN,5676,1688,7364
12920,SUMATERA BARAT,13253,PADANG PARIAMAN,13266,2 X 11 KAYU TANAM,8807,2678,11485
12920,SUMATERA BARAT,13253,PADANG PARIAMAN,13271,VII KOTO SUNGAI SARIK,11635,4194,15829
12920,SUMATERA BARAT,13253,PADANG PARIAMAN,13287,ULAKAN TAPAKIH,6696,1771,8467
12920,SUMATERA BARAT,13317,AGAM,13380,PALUPUH,5158,1242,6400
12920,SUMATERA BARAT,13317,AGAM,13385,PELEMBAYAN,11355,2205,13560
12920,SUMATERA BARAT,13317,AGAM,13398,AMPEK NAGARI,8612,2306,10918
12920,SUMATERA BARAT,13317,AGAM,13328,TANJUNG RAYA,13017,2843,15860
12920,SUMATERA BARAT,13253,PADANG PARIAMAN,13260,NAN SABARIS,10825,2050,12875
12920,SUMATERA BARAT,13317,AGAM,13392,SUNGAI PUA,9093,1753,10846
12920,SUMATERA BARAT,13317,AGAM,13353,BANUHAMPU,14317,2522,16839
12920,SUMATERA BARAT,13253,PADANG PARIAMAN,13256,BATANG ANAI,14936,3786,18722
12920,SUMATERA BARAT,13317,AGAM,13407,KAMANG MAGEK,9425,1691,11116
12920,SUMATERA BARAT,13416,LIMA PULUH KOTA,13417,SULIKI,5588,1711,7299
12920,SUMATERA BARAT,13317,AGAM,13403,CANDUNG,8670,1787,10457
12920,SUMATERA BARAT,13416,LIMA PULUH KOTA,13474,LAREH SAGO HALABAN,14331,4617,18948
12920,SUMATERA BARAT,13317,AGAM,13376,TILATANG KAMANG,14173,2953,17126
12920,SUMATERA BARAT,13317,AGAM,13345,IV KOTO,9894,1639,11533
12920,SUMATERA BARAT,13317,AGAM,13369,BASO,12864,2871,15735
12920,SUMATERA BARAT,13416,LIMA PULUH KOTA,13424,GUGUAK,13440,4045,17485
12920,SUMATERA BARAT,13416,LIMA PULUH KOTA,13495,BUKIK BARISAN,9332,1789,11121
12920,SUMATERA BARAT,13416,LIMA PULUH KOTA,13438,LUAK,11062,2388,13450
12920,SUMATERA BARAT,13416,LIMA PULUH KOTA,13483,SITUJUAH LIMO NAGARI,8640,2074,10714
12920,SUMATERA BARAT,13416,LIMA PULUH KOTA,13470,GUNUANG OMEH,4834,1426,6260
12920,SUMATERA BARAT,13317,AGAM,13322,LUBUK BASUNG,23529,6334,29863
12920,SUMATERA BARAT,13317,AGAM,13338,MATUR,7477,1340,8817
12920,SUMATERA BARAT,13416,LIMA PULUH KOTA,13489,MUNGKA,9650,2084,11734
12920,SUMATERA BARAT,13416,LIMA PULUH KOTA,13489,MUNGKA,9650,2084,11734
12920,SUMATERA BARAT,13509,PASAMAN,13531,TIGO NAGARI,7644,1702,9346
12920,SUMATERA BARAT,13416,LIMA PULUH KOTA,13489,MUNGKA,9650,2084,11734
12920,SUMATERA BARAT,13509,PASAMAN,13531,TIGO NAGARI,7644,1702,9346
12920,SUMATERA BARAT,13416,LIMA PULUH KOTA,13462,KAPUR IX,8460,2862,11322
12920,SUMATERA BARAT,13509,PASAMAN,13544,PADANG GELUGUR,10148,2766,12914
12920,SUMATERA BARAT,13509,PASAMAN,13538,MAPAT TUNGGUL SELATAN,3120,1120,4240
12920,SUMATERA BARAT,13416,LIMA PULUH KOTA,13443,HARAU,17964,4949,22913
12920,SUMATERA BARAT,13416,LIMA PULUH KOTA,13430,PAYAKUMBUH,12815,2761,15576
12920,SUMATERA BARAT,13509,PASAMAN,13510,BONJOL,8207,1880,10087
12920,SUMATERA BARAT,13317,AGAM,13411,MALALAK,3628,613,4241
12920,SUMATERA BARAT,13509,PASAMAN,13515,LUBUK SIKAPING,19038,3231,22269
12920,SUMATERA BARAT,13509,PASAMAN,13550,RAO SELATAN,8978,2319,11297
12920,SUMATERA BARAT,13509,PASAMAN,13524,MAPAT TUNGGUL,2915,1845,4760
12920,SUMATERA BARAT,13554,KEPULAUAN MENTAWAI,13555,PAGAI UTARA,0,0,0
12920,SUMATERA BARAT,13509,PASAMAN,13522,PANTI,9871,3635,13506
12920,SUMATERA BARAT,13509,PASAMAN,13528,DUO KOTO,7767,3060,10827
12920,SUMATERA BARAT,13554,KEPULAUAN MENTAWAI,13599,SIKAKAP,0,0,0
12920,SUMATERA BARAT,13509,PASAMAN,13535,RAO,7961,3385,11346
12920,SUMATERA BARAT,13416,LIMA PULUH KOTA,13501,AKABILURU,10465,1721,12186
12920,SUMATERA BARAT,13416,LIMA PULUH KOTA,13455,PANGKALAN KOTO BARU,10502,2272,12774
12920,SUMATERA BARAT,13554,KEPULAUAN MENTAWAI,13567,SIBERUT SELATAN,0,0,0
12920,SUMATERA BARAT,13554,KEPULAUAN MENTAWAI,13584,SIBERUT BARAT DAYA,0,0,0
12920,SUMATERA BARAT,13509,PASAMAN,13541,SIMPANG ALAHAN MATI,3971,661,4632
12920,SUMATERA BARAT,13554,KEPULAUAN MENTAWAI,13580,SIBERUT BARAT,0,0,0
12920,SUMATERA BARAT,13554,KEPULAUAN MENTAWAI,13592,SIPORA UTARA,0,0,0
12920,SUMATERA BARAT,13554,KEPULAUAN MENTAWAI,13588,SIBERUT TENGAH,0,0,0
12920,SUMATERA BARAT,13509,PASAMAN,13546,RAO UTARA,4623,1040,5663
12920,SUMATERA BARAT,13554,KEPULAUAN MENTAWAI,13559,SIPORA SELATAN,0,0,0
12920,SUMATERA BARAT,13608,DHARMASRAYA,13609,KOTO BARU,11072,4531,15603
12920,SUMATERA BARAT,13608,DHARMASRAYA,83413,TIUMANG,3588,3345,6933
12920,SUMATERA BARAT,13554,KEPULAUAN MENTAWAI,13573,SIBERUT UTARA,0,0,0
12920,SUMATERA BARAT,13608,DHARMASRAYA,83412,KOTO SALAK,5324,4371,9695
12920,SUMATERA BARAT,13608,DHARMASRAYA,83415,ASAM JUJUHAN,4257,1595,5852
12920,SUMATERA BARAT,13608,DHARMASRAYA,83414,PADANG LAWEH,1983,1169,3152
12920,SUMATERA BARAT,13608,DHARMASRAYA,13630,SITIUNG,9578,3881,13459
12920,SUMATERA BARAT,13554,KEPULAUAN MENTAWAI,13603,PAGAI SELATAN,0,0,0
12920,SUMATERA BARAT,13608,DHARMASRAYA,83411,TIMPEH,4678,3173,7851
12920,SUMATERA BARAT,13608,DHARMASRAYA,13623,SUNGAI RUMBAI,5003,4837,9840
12920,SUMATERA BARAT,13634,SOLOK SELATAN,13663,SANGIR BATANG HARI,4920,2411,7331
12920,SUMATERA BARAT,13634,SOLOK SELATAN,13635,SANGIR,13722,4466,18188
12920,SUMATERA BARAT,13608,DHARMASRAYA,83416,KOTO BESAR,7452,4523,11975
12920,SUMATERA BARAT,13634,SOLOK SELATAN,13640,SUNGAI PAGU,11577,2697,14274
12920,SUMATERA BARAT,13634,SOLOK SELATAN,13657,SANGIR JUJUAN,5340,1078,6418
12920,SUMATERA BARAT,13608,DHARMASRAYA,13617,PULAU PUNJUNG,14604,4167,18771
12920,SUMATERA BARAT,13681,PASAMAN BARAT,13690,TALAMAU,11156,1890,13046
12920,SUMATERA BARAT,13608,DHARMASRAYA,83410,SEMBILAN KOTO,2602,1145,3747
12920,SUMATERA BARAT,13634,SOLOK SELATAN,13676,SANGIR BALAI JANGGO,6212,2771,8983
12920,SUMATERA BARAT,13681,PASAMAN BARAT,13697,GUNUNG TULEH,0,0,0
12920,SUMATERA BARAT,13681,PASAMAN BARAT,13703,KOTO BALINGKA,8334,3546,11880
12920,SUMATERA BARAT,13681,PASAMAN BARAT,13682,SUNGAI BEREMAS,7121,1775,8896
12920,SUMATERA BARAT,13681,PASAMAN BARAT,13694,KINALI,20039,8905,28944
12920,SUMATERA BARAT,13681,PASAMAN BARAT,13684,LEMBAH MELINTANG,14078,3312,17390
12920,SUMATERA BARAT,13681,PASAMAN BARAT,13707,LUHAK NAN DUO,13729,5522,19251
12920,SUMATERA BARAT,13681,PASAMAN BARAT,13710,SASAK RANAH PESISIA,4940,1703,6643
12920,SUMATERA BARAT,13712,KOTA PADANG,13756,BUNGUS TELUK KABUNG,8788,1516,10304
12920,SUMATERA BARAT,13712,KOTA PADANG,13713,PADANG SELATAN,18798,9241,28039
12920,SUMATERA BARAT,13712,KOTA PADANG,13814,KOTO TANGAH,59982,17433,77415
12920,SUMATERA BARAT,13681,PASAMAN BARAT,13700,RANAH BATAHAN,9098,3287,12385
12920,SUMATERA BARAT,13634,SOLOK SELATAN,13652,KOTO PARIK GADANG DIATEH,7881,2064,9945
12920,SUMATERA BARAT,13712,KOTA PADANG,13737,PADANG BARAT,14282,8106,22388
12920,SUMATERA BARAT,13681,PASAMAN BARAT,13705,SUNGAI AUA,10071,4072,14143
12920,SUMATERA BARAT,13712,KOTA PADANG,13726,PADANG TIMUR,29436,7665,37101
12920,SUMATERA BARAT,13634,SOLOK SELATAN,13671,PAUH DUO,6413,1616,8029
12920,SUMATERA BARAT,13712,KOTA PADANG,13787,PAUH,22107,4039,26146
12920,SUMATERA BARAT,13712,KOTA PADANG,13807,NANGGALO,21193,5640,26833
