#HEADER:ProvinceCode,ProvinceName,KabupatenCode,KabupatenName,KecamatanCode,KecamatanName,PrabowoHattaVotes,JokowiKallaVotes,TotalVotes
1,ACEH,1492,ACEH BARAT,1672,ARONGAN LAMBALEK,2261,3316,5577
1,ACEH,1492,ACEH BARAT,1654,BUBON,1732,1800,3532
1,ACEH,1492,ACEH BARAT,1493,JOHAN PAHWALAN,13649,10052,23701
1,ACEH,1492,ACEH BARAT,1515,KAWAY XVI,5921,4506,10427
1,ACEH,1492,ACEH BARAT,1726,MEUREUBO,5705,5686,11391
1,ACEH,1492,ACEH BARAT,1700,PANTE CEUREUMEN,3245,2270,5515
1,ACEH,1492,ACEH BARAT,1804,PANTON REU,1930,1100,3030
1,ACEH,1492,ACEH BARAT,1621,SAMATIGA,3904,4284,8188
1,ACEH,1492,ACEH BARAT,1559,SUNGAI MAS,1218,845,2063
1,ACEH,1492,ACEH BARAT,1577,WOYLA,4000,3208,7208
1,ACEH,1492,ACEH BARAT,1753,WOYLA BARAT,2425,1714,4139
1,ACEH,1492,ACEH BARAT,1778,WOYLA TIMUR,1345,1281,2626
1,ACEH,4989,ACEH BARAT DAYA,5093,BABAH ROT,2284,3615,5899
1,ACEH,4989,ACEH BARAT DAYA,4990,BLANG PIDIE,4780,3709,8489
1,ACEH,4989,ACEH BARAT DAYA,5127,JEUMPA,2860,1536,4396
1,ACEH,4989,ACEH BARAT DAYA,5074,KUALA BATEE,3972,3536,7508
1,ACEH,4989,ACEH BARAT DAYA,5104,LEMBAH SABIL,0,0,0
1,ACEH,4989,ACEH BARAT DAYA,5027,MANGGENG,3479,2648,6127
1,ACEH,4989,ACEH BARAT DAYA,5118,SETIA,1239,1627,2866
1,ACEH,4989,ACEH BARAT DAYA,5045,SUSOH,4895,5305,10200
1,ACEH,1824,ACEH BESAR,2391,BAITUSSALAM,3779,3160,6939
1,ACEH,1824,ACEH BESAR,2425,BLANG BINTANG,3053,2148,5201
1,ACEH,1824,ACEH BESAR,2060,DARUL IMARAH,11484,7981,19465
1,ACEH,1824,ACEH BESAR,2376,DARUL KAMAL,1819,1599,3418
1,ACEH,1824,ACEH BESAR,2233,DARUSSALAM,5537,3722,9259
1,ACEH,1824,ACEH BESAR,1883,INDRAPURI,6377,3906,10283
1,ACEH,1824,ACEH BESAR,2134,INGIN JAYA,8026,6351,14377
1,ACEH,1824,ACEH BESAR,2308,KOTA COT GLIE,3272,3379,6651
1,ACEH,1824,ACEH BESAR,2294,KOTA JANTHO,1967,2018,3985
1,ACEH,1824,ACEH BESAR,2185,KUTA BARO,6132,5241,11373
1,ACEH,1824,ACEH BESAR,2341,KUTA MALAKA,2158,1042,3200
1,ACEH,1824,ACEH BESAR,2418,LEUPUNG,631,763,1394
1,ACEH,1824,ACEH BESAR,1854,LHOKNGA,4580,3111,7691
1,ACEH,1824,ACEH BESAR,1825,LHOONG,2779,2419,5198
1,ACEH,1824,ACEH BESAR,2120,MESJID RAYA,3001,3257,6258
1,ACEH,1824,ACEH BESAR,1984,MONTASIK,6373,3074,9447
1,ACEH,1824,ACEH BESAR,2093,PEUKAN BADA,3778,3662,7440
1,ACEH,1824,ACEH BESAR,2263,PULO ACEH,1127,1301,2428
1,ACEH,1824,ACEH BESAR,1936,SEULIMEUM,4693,5158,9851
1,ACEH,1824,ACEH BESAR,2357,SIMPANG TIGA,1857,1176,3033
1,ACEH,1824,ACEH BESAR,2024,SUKAMAKMUR,4189,3170,7359
1,ACEH,5286,ACEH JAYA,83452,DARUL HIKMAH,1779,1271,3050
1,ACEH,5286,ACEH JAYA,83451,INDRA JAYA,2307,1233,3540
1,ACEH,5286,ACEH JAYA,5394,JAYA,5321,2147,7468
1,ACEH,5286,ACEH JAYA,5324,KRUENG SABEE,0,0,0
1,ACEH,5286,ACEH JAYA,5443,PANGA,1458,1992,3450
1,ACEH,5286,ACEH JAYA,83453,PASIE RAYA,0,0,0
1,ACEH,5286,ACEH JAYA,5356,SAMPOINIET,1453,1618,3071
1,ACEH,5286,ACEH JAYA,5342,SETIA BAKTI,1729,1593,3322
1,ACEH,5286,ACEH JAYA,5287,TEUNOM,3345,3199,6544
1,ACEH,2,ACEH SELATAN,3,BAKONGAN,0,0,0
1,ACEH,2,ACEH SELATAN,182,BAKONGAN TIMUR,1027,1230,2257
1,ACEH,2,ACEH SELATAN,29,KLUET SELATAN,2779,3259,6038
1,ACEH,2,ACEH SELATAN,190,KLUET TENGAH,0,0,0
1,ACEH,2,ACEH SELATAN,204,KLUET TIMUR,2552,1689,4241
1,ACEH,2,ACEH SELATAN,9,KLUET UTARA,5194,5108,10302
1,ACEH,2,ACEH SELATAN,248,KOTA BAHAGIA,1172,1389,2561
1,ACEH,2,ACEH SELATAN,47,LABUHAN HAJI,0,0,0
1,ACEH,2,ACEH SELATAN,222,LABUHAN HAJI BARAT,3584,3200,6784
1,ACEH,2,ACEH SELATAN,236,LABUHAN HAJI TIMUR,0,0,0
1,ACEH,2,ACEH SELATAN,64,MEUKEK,5016,3676,8692
1,ACEH,2,ACEH SELATAN,161,PASIE RAJA,3470,2925,6395
1,ACEH,2,ACEH SELATAN,87,SAMADUA,6333,2476,8809
1,ACEH,2,ACEH SELATAN,116,SAWANG,4676,2743,7419
1,ACEH,2,ACEH SELATAN,132,TAPAKTUAN,7752,3401,11153
1,ACEH,2,ACEH SELATAN,148,TRUMON,950,1174,2124
1,ACEH,2,ACEH SELATAN,259,TRUMON TENGAH,0,0,0
1,ACEH,2,ACEH SELATAN,212,TRUMON TIMUR,0,0,0
1,ACEH,4233,ACEH SINGKIL,4329,DANAU PARIS,1054,1273,2327
1,ACEH,4233,ACEH SINGKIL,4285,GUNUNG MERIAH,9059,5549,14608
1,ACEH,4233,ACEH SINGKIL,4311,KOTA BAHARU,1627,1031,2658
1,ACEH,4233,ACEH SINGKIL,4355,KUALA BARU,569,413,982
1,ACEH,4233,ACEH SINGKIL,4234,PULAU BANYAK,838,574,1412
1,ACEH,4233,ACEH SINGKIL,4360,PULAU BANYAK BARAT,370,654,1024
1,ACEH,4233,ACEH SINGKIL,4242,SIMPANG KANAN,3821,2613,6434
1,ACEH,4233,ACEH SINGKIL,4268,SINGKIL,4907,2480,7387
1,ACEH,4233,ACEH SINGKIL,4321,SINGKIL UTARA,2008,1810,3818
1,ACEH,4233,ACEH SINGKIL,4348,SINGKOHOR,1795,1135,2930
1,ACEH,4233,ACEH SINGKIL,4336,SURO MAKMUR,1233,1698,2931
1,ACEH,5694,ACEH TAMIANG,5872,BANDA MULIA,3180,1373,4553
1,ACEH,5694,ACEH TAMIANG,5883,BANDAR PUSAKA,3303,2136,5439
1,ACEH,5694,ACEH TAMIANG,5732,BENDAHARA,5617,2931,8548
1,ACEH,5694,ACEH TAMIANG,5766,KARANG BARU,12432,5320,17752
1,ACEH,5694,ACEH TAMIANG,5829,KEJURUAN MUDA,9005,5757,14762
1,ACEH,5694,ACEH TAMIANG,5823,KOTA KUALASIMPANG,4391,2982,7373
1,ACEH,5694,ACEH TAMIANG,5695,MANYAK PAYED,7261,4187,11448
1,ACEH,5694,ACEH TAMIANG,5855,RANTAU,10874,4766,15640
1,ACEH,5694,ACEH TAMIANG,5905,SEKERAK,1990,1106,3096
1,ACEH,5694,ACEH TAMIANG,5798,SERUWAY,6817,4801,11618
1,ACEH,5694,ACEH TAMIANG,5845,TAMIANG HULU,5532,2790,8322
1,ACEH,5694,ACEH TAMIANG,5899,TENGGULUN,3867,2994,6861
1,ACEH,1207,ACEH TENGAH,1322,ATU LINTANG,1972,1413,3385
1,ACEH,1207,ACEH TENGAH,1267,BEBESEN,6936,9334,16270
1,ACEH,1207,ACEH TENGAH,1295,BIES,1865,2243,4108
1,ACEH,1207,ACEH TENGAH,1362,BINTANG,1225,4038,5263
1,ACEH,1207,ACEH TENGAH,1459,CELALA,1747,3106,4853
1,ACEH,1207,ACEH TENGAH,1386,JAGONG JEGET,3274,1968,5242
1,ACEH,1207,ACEH TENGAH,1420,KEBAYAKAN,3047,4750,7797
1,ACEH,1207,ACEH TENGAH,1394,KETOL,3311,3819,7130
1,ACEH,1207,ACEH TENGAH,1440,KUTE PANANG,1463,2745,4208
1,ACEH,1207,ACEH TENGAH,1476,LAUT TAWAR,3987,5035,9022
1,ACEH,1207,ACEH TENGAH,1208,LINGE,2239,3127,5366
1,ACEH,1207,ACEH TENGAH,1332,PEGASING,3528,6690,10218
1,ACEH,1207,ACEH TENGAH,1307,RUSIP ANTARA,1525,2194,3719
1,ACEH,1207,ACEH TENGAH,1233,SILIH NARA,4403,7420,11823
1,ACEH,269,ACEH TENGGARA,416,BABUL MAKMUR,0,0,0
1,ACEH,269,ACEH TENGGARA,536,BABUL RAHMAH,0,0,0
1,ACEH,269,ACEH TENGGARA,369,BABUSSALAM,0,0,0
1,ACEH,269,ACEH TENGGARA,397,BADAR,0,0,0
1,ACEH,269,ACEH TENGGARA,335,BAMBEL,7774,2528,10302
1,ACEH,269,ACEH TENGGARA,492,BUKIT TUSAM,0,0,0
1,ACEH,269,ACEH TENGGARA,438,DARUL HASANAH,0,0,0
1,ACEH,269,ACEH TENGGARA,590,DELENG POKHKISEN,0,0,0
1,ACEH,269,ACEH TENGGARA,564,KETAMBE,3705,2347,6052
1,ACEH,269,ACEH TENGGARA,270,LAWE ALAS,7473,2030,9503
1,ACEH,269,ACEH TENGGARA,467,LAWE BULAN,6165,2590,8755
1,ACEH,269,ACEH TENGGARA,613,LAWE SUMUR,0,0,0
1,ACEH,269,ACEH TENGGARA,647,LEUSER,0,0,0
1,ACEH,269,ACEH TENGGARA,516,SEMADAM,0,0,0
1,ACEH,269,ACEH TENGGARA,632,TANOH ALAS,1398,881,2279
1,ACEH,671,ACEH TIMUR,1063,BANDA ALAM,960,1731,2691
1,ACEH,671,ACEH TIMUR,792,BIREM BAYEUN,8471,3382,11853
1,ACEH,671,ACEH TIMUR,672,DARUL AMAN,2354,3297,5651
1,ACEH,671,ACEH TIMUR,1175,DARUL FALAH,442,1084,1526
1,ACEH,671,ACEH TIMUR,1158,DARUL IHSAN,1155,1195,2350
1,ACEH,671,ACEH TIMUR,756,IDI RAYEUK,5577,5106,10683
1,ACEH,671,ACEH TIMUR,1187,IDI TIMUR,824,1153,1977
1,ACEH,671,ACEH TIMUR,1037,IDI TUNONG,1746,1748,3494
1,ACEH,671,ACEH TIMUR,1023,INDRA MAKMU,4063,1733,5796
1,ACEH,671,ACEH TIMUR,718,JULOK,3589,4736,8325
1,ACEH,671,ACEH TIMUR,996,MADAT,3393,3941,7334
1,ACEH,671,ACEH TIMUR,838,NURUSSALAM,2570,3702,6272
1,ACEH,671,ACEH TIMUR,972,PANTE BIDARI,2626,4052,6678
1,ACEH,671,ACEH TIMUR,1080,PEUDAWA,1637,1673,3310
1,ACEH,671,ACEH TIMUR,1201,PEUNARON,2315,1801,4116
1,ACEH,671,ACEH TIMUR,870,PEUREULAK,4870,6850,11720
1,ACEH,671,ACEH TIMUR,1119,PEUREULAK BARAT,2282,2048,4330
1,ACEH,671,ACEH TIMUR,1098,PEUREULAK TIMUR,1391,2678,4069
1,ACEH,671,ACEH TIMUR,948,RANTAU PEUREULAK,5339,3238,8577
1,ACEH,671,ACEH TIMUR,909,RANTAU SELAMAT,1835,1942,3777
1,ACEH,671,ACEH TIMUR,820,SERBAJADI,1893,1267,3160
1,ACEH,671,ACEH TIMUR,1149,SIMPANG JERNIH,1300,544,1844
1,ACEH,671,ACEH TIMUR,924,SIMPANG ULIM,2492,2775,5267
1,ACEH,671,ACEH TIMUR,1135,SUNGAI RAYA,1477,1872,3349
1,ACEH,3205,ACEH UTARA,3206,BAKTIYA,7176,6433,13609
1,ACEH,3205,ACEH UTARA,3916,BAKTIYA BARAT,2948,3224,6172
1,ACEH,3205,ACEH UTARA,4069,BANDA BARO,1705,695,2400
1,ACEH,3205,ACEH UTARA,3867,COT GIREK,6352,2450,8802
1,ACEH,3205,ACEH UTARA,3264,DEWANTARA,8254,4449,12703
1,ACEH,3205,ACEH UTARA,4057,GEUREDONG PASE,1563,533,2096
1,ACEH,3205,ACEH UTARA,3280,KUTA MAKMUR,6314,3703,10017
1,ACEH,3205,ACEH UTARA,3892,LANGKAHAN,4194,3819,8013
1,ACEH,3205,ACEH UTARA,4021,LAPANG,1181,1280,2461
1,ACEH,3205,ACEH UTARA,3320,LHOKSUKON,9549,7667,17216
1,ACEH,3205,ACEH UTARA,3397,MATANGKULI,3872,3445,7317
1,ACEH,3205,ACEH UTARA,3472,MEURAH MULIA,3965,3782,7747
1,ACEH,3205,ACEH UTARA,3447,MUARA BATU,5837,2986,8823
1,ACEH,3205,ACEH UTARA,3983,NIBONG,2514,1675,4189
1,ACEH,3205,ACEH UTARA,3837,NISAM,4535,1928,6463
1,ACEH,3205,ACEH UTARA,4079,NISAM ANTARA,1611,937,2548
1,ACEH,3205,ACEH UTARA,3943,PAYA BAKONG,2984,2449,5433
1,ACEH,3205,ACEH UTARA,4033,PIRAK TIMUR,1775,1507,3282
1,ACEH,3205,ACEH UTARA,3523,SAMUDERA,6294,3771,10065
1,ACEH,3205,ACEH UTARA,3797,SAWANG,7866,3931,11797
1,ACEH,3205,ACEH UTARA,3564,SEUNUDDON,6338,2800,9138
1,ACEH,3205,ACEH UTARA,4004,SIMPANG KRAMAT,2801,1284,4085
1,ACEH,3205,ACEH UTARA,3598,SYAMTALIRA ARON,4374,3121,7495
1,ACEH,3205,ACEH UTARA,3633,SYAMTALIRA BAYU,4800,2801,7601
1,ACEH,3205,ACEH UTARA,3672,TANAH LUAS,6213,4120,10333
1,ACEH,3205,ACEH UTARA,3730,TANAH PASIR,1867,1427,3294
1,ACEH,5920,BENER MERIAH,6045,BANDAR,0,0,0
1,ACEH,5920,BENER MERIAH,6126,BENER KELIPAH,759,1531,2290
1,ACEH,5920,BENER MERIAH,5976,BUKIT,0,0,0
1,ACEH,5920,BENER MERIAH,6155,GAJAH PUTIH,0,0,0
1,ACEH,5920,BENER MERIAH,6139,MESIDAH,635,1445,2080
1,ACEH,5920,BENER MERIAH,6098,PERMATA,0,0,0
1,ACEH,5920,BENER MERIAH,5952,PINTU RIME GAYO,1965,3742,5707
1,ACEH,5920,BENER MERIAH,6081,SYIAH UTAMA,300,653,953
1,ACEH,5920,BENER MERIAH,5921,TIMANG GAJAH,0,0,0
1,ACEH,5920,BENER MERIAH,6017,WIH PESAM,5304,5670,10974
1,ACEH,4362,BIREUEN,4648,GANDAPURA,6515,2592,9107
1,ACEH,4362,BIREUEN,4746,JANGKA,5432,4381,9813
1,ACEH,4362,BIREUEN,4507,JEUMPA,7113,4486,11599
1,ACEH,4362,BIREUEN,4410,JEUNIEB,7878,3096,10974
1,ACEH,4362,BIREUEN,4709,JULI,7180,4581,11761
1,ACEH,4362,BIREUEN,4858,KOTA JUANG,10759,5952,16711
1,ACEH,4362,BIREUEN,4882,KUALA,4215,2235,6450
1,ACEH,4362,BIREUEN,4947,KUTA BLANG,5773,2745,8518
1,ACEH,4362,BIREUEN,4620,MAKMUR,3523,2013,5536
1,ACEH,4362,BIREUEN,4689,PANDRAH,2018,1335,3353
1,ACEH,4362,BIREUEN,4454,PEUDADA,5264,5031,10295
1,ACEH,4362,BIREUEN,4835,PEULIMBANG,2180,2342,4522
1,ACEH,4362,BIREUEN,4550,PEUSANGAN,11179,7392,18571
1,ACEH,4362,BIREUEN,4925,PEUSANGAN SELATAN,3085,2060,5145
1,ACEH,4362,BIREUEN,4903,PEUSANGAN SIBLAH KRUENG,2839,1838,4677
1,ACEH,4362,BIREUEN,4363,SAMALANGA,6185,3652,9837
1,ACEH,4362,BIREUEN,4793,SIMPANG MAMPLAM,4639,4356,8995
1,ACEH,5138,GAYO LUES,5254,BLANGJERANGO,1201,2483,3684
1,ACEH,5138,GAYO LUES,5152,BLANGKEJEREN,0,0,0
1,ACEH,5138,GAYO LUES,5231,BLANGPEGAYON,1155,1465,2620
1,ACEH,5138,GAYO LUES,5221,DABUN GELANG,1233,1499,2732
1,ACEH,5138,GAYO LUES,5139,KUTAPANJANG,1536,2498,4034
1,ACEH,5138,GAYO LUES,5265,PANTAN CUACA,714,1561,2275
1,ACEH,5138,GAYO LUES,5211,PINING,680,1444,2124
1,ACEH,5138,GAYO LUES,5244,PUTERI BETUNG,1259,2673,3932
1,ACEH,5138,GAYO LUES,5173,RIKIT GAIB,0,0,0
1,ACEH,5138,GAYO LUES,5187,TERANGUN,2187,2268,4455
1,ACEH,5138,GAYO LUES,5275,TERIPE JAYA,0,0,0
1,ACEH,6397,KOTA BANDA ACEH,6398,BAITURRAHMAN,6679,5261,11940
1,ACEH,6397,KOTA BANDA ACEH,6466,BANDA RAYA,5642,3709,9351
1,ACEH,6397,KOTA BANDA ACEH,6477,JAYA BARU,4594,3471,8065
1,ACEH,6397,KOTA BANDA ACEH,6409,KUTA ALAM,8282,6568,14850
1,ACEH,6397,KOTA BANDA ACEH,6459,KUTA RAJA,1716,1702,3418
1,ACEH,6397,KOTA BANDA ACEH,6449,LUENG BATA,4387,3644,8031
1,ACEH,6397,KOTA BANDA ACEH,6421,MEURAXA,3215,3080,6295
1,ACEH,6397,KOTA BANDA ACEH,6438,SYIAH KUALA,6280,4618,10898
1,ACEH,6397,KOTA BANDA ACEH,6487,ULEE KARENG,5028,3950,8978
1,ACEH,6591,KOTA LANGSA,6607,LANGSA BARAT,6976,3235,10211
1,ACEH,6591,KOTA LANGSA,6638,LANGSA BARO,14232,5092,19324
1,ACEH,6591,KOTA LANGSA,6617,LANGSA KOTA,8533,4667,13200
1,ACEH,6591,KOTA LANGSA,6628,LANGSA LAMA,9313,3508,12821
1,ACEH,6591,KOTA LANGSA,6592,LANGSA TIMUR,3639,1838,5477
1,ACEH,6518,KOTA LHOKSEUMAWE,6537,BANDA SAKTI,14892,8317,23209
1,ACEH,6518,KOTA LHOKSEUMAWE,6556,BLANG MANGAT,4426,3013,7439
1,ACEH,6518,KOTA LHOKSEUMAWE,6519,MUARA DUA,9299,4709,14008
1,ACEH,6518,KOTA LHOKSEUMAWE,6579,MUARA SATU,5999,3257,9256
1,ACEH,6497,KOTA SABANG,6507,SUKAJAYA,3746,2619,6365
1,ACEH,6497,KOTA SABANG,6498,SUKAKARYA,3555,2918,6473
1,ACEH,6648,KOTA SUBULUSSALAM,6717,LONGKIB,1494,1039,2533
1,ACEH,6648,KOTA SUBULUSSALAM,6664,PENANGGALAN,3299,2038,5337
1,ACEH,6648,KOTA SUBULUSSALAM,6675,RUNDENG,3764,1685,5449
1,ACEH,6648,KOTA SUBULUSSALAM,6649,SIMPANG KIRI,7966,4310,12276
1,ACEH,6648,KOTA SUBULUSSALAM,6699,SULTAN DAULAT,3649,2204,5853
1,ACEH,5463,NAGAN RAYA,5552,BEUTONG,2308,4007,6315
1,ACEH,5463,NAGAN RAYA,83457,BEUTONG ATEUH BANGGALANG,308,553,861
1,ACEH,5463,NAGAN RAYA,5581,DARUL MAKMUR,10555,9416,19971
1,ACEH,5463,NAGAN RAYA,5464,KUALA,4447,4269,8716
1,ACEH,5463,NAGAN RAYA,5654,KUALA PESISIR,4204,3819,8023
1,ACEH,5463,NAGAN RAYA,5482,SEUNAGAN,3480,4764,8244
1,ACEH,5463,NAGAN RAYA,5517,SEUNAGAN TIMUR,3125,4321,7446
1,ACEH,5463,NAGAN RAYA,5634,SUKA MAKMUE,2077,2852,4929
1,ACEH,5463,NAGAN RAYA,5671,TADU RAYA,3129,3235,6364
1,ACEH,5463,NAGAN RAYA,83454,TRIPA MAKMUR,1932,1612,3544
1,ACEH,2452,PIDIE,2453,BATEE,0,0,0
1,ACEH,2452,PIDIE,2482,DELIMA,0,0,0
1,ACEH,2452,PIDIE,2533,GEULUMPANG TIGA,0,0,0
1,ACEH,2452,PIDIE,2527,GEUMPANG,785,1158,1943
1,ACEH,2452,PIDIE,3169,GLUMPANG BARO,1565,2941,4506
1,ACEH,2452,PIDIE,2568,INDRA JAYA,3618,5734,9352
1,ACEH,2452,PIDIE,2618,KEMBANG TANJONG,3411,5241,8652
1,ACEH,2452,PIDIE,3081,KEUMALA,1032,2969,4001
1,ACEH,2452,PIDIE,2664,KOTA SIGLI,3518,3742,7260
1,ACEH,2452,PIDIE,3164,MANE,976,1397,2373
1,ACEH,2452,PIDIE,2680,MILA,1760,1958,3718
1,ACEH,2452,PIDIE,2701,MUARA TIGA,4865,1867,6732
1,ACEH,2452,PIDIE,2720,MUTIARA,3270,4973,8243
1,ACEH,2452,PIDIE,3099,MUTIARA TIMUR,4938,8418,13356
1,ACEH,2452,PIDIE,2750,PADANG TIJI,4002,5167,9169
1,ACEH,2452,PIDIE,2815,PEUKAN BARO,0,0,0
1,ACEH,2452,PIDIE,2864,PIDIE,0,0,0
1,ACEH,2452,PIDIE,2929,SAKTI,0,0,0
1,ACEH,2452,PIDIE,2979,SIMPANG TIGA,4660,5611,10271
1,ACEH,2452,PIDIE,3032,TANGSE,5198,6186,11384
1,ACEH,2452,PIDIE,3191,TITEUE,1110,1353,2463
1,ACEH,6166,PIDIE JAYA,6314,BANDAR BARU,6010,6710,12720
1,ACEH,6166,PIDIE JAYA,6248,BANDAR DUA,3590,4847,8437
1,ACEH,6166,PIDIE JAYA,6229,JANGKA BUYA,1195,2071,3266
1,ACEH,6166,PIDIE JAYA,6294,MEURAH DUA,2344,2740,5084
1,ACEH,6166,PIDIE JAYA,6167,MEUREUDU,3636,4771,8407
1,ACEH,6166,PIDIE JAYA,6358,PANTERAJA,1521,1300,2821
1,ACEH,6166,PIDIE JAYA,6369,TRIENGGADENG,3869,4105,7974
1,ACEH,6166,PIDIE JAYA,6198,ULIM,1917,3794,5711
1,ACEH,4086,SIMEULUE,4224,ALAPAN,0,0,0
1,ACEH,4086,SIMEULUE,4112,SALANG,0,0,0
1,ACEH,4086,SIMEULUE,4189,SIMEULUE BARAT,0,0,0
1,ACEH,4086,SIMEULUE,83456,SIMEULUE CUT,0,0,0
1,ACEH,4086,SIMEULUE,4087,SIMEULUE TENGAH,0,0,0
1,ACEH,4086,SIMEULUE,4148,SIMEULUE TIMUR,0,0,0
1,ACEH,4086,SIMEULUE,4178,TELUK DALAM,0,0,0
1,ACEH,4086,SIMEULUE,4129,TEUPAH BARAT,0,0,0
1,ACEH,4086,SIMEULUE,4204,TEUPAH SELATAN,0,0,0
1,ACEH,4086,SIMEULUE,83455,TEUPAH TENGAH,0,0,0
53241,BALI,53439,BADUNG,53467,ABIANSEMAL,16355,40988,57343
53241,BALI,53439,BADUNG,53440,KUTA,6269,18968,25237
53241,BALI,53439,BADUNG,53494,KUTA SELATAN,15350,32360,47710
53241,BALI,53439,BADUNG,53501,KUTA UTARA,12115,32165,44280
53241,BALI,53439,BADUNG,53446,MENGWI,21692,52545,74237
53241,BALI,53439,BADUNG,53486,PETANG,6285,12191,18476
53241,BALI,53650,BANGLI,53661,BANGLI,9187,22608,31795
53241,BALI,53650,BANGLI,53678,KINTAMANI,14039,40783,54822
53241,BALI,53650,BANGLI,53651,SUSUT,8102,20530,28632
53241,BALI,53650,BANGLI,53671,TEMBUKU,5989,18607,24596
53241,BALI,53814,BULELENG,53868,BANJAR,12583,28070,40653
53241,BALI,53814,BULELENG,53902,BULELENG,20569,45577,66146
53241,BALI,53814,BULELENG,53852,BUSUNG BIU,7294,17486,24780
53241,BALI,53814,BULELENG,53815,GEROKGAK,15376,26829,42205
53241,BALI,53814,BULELENG,53947,KUBUTAMBAHAN,7441,19231,26672
53241,BALI,53814,BULELENG,53932,SAWAN,8168,24260,32428
53241,BALI,53814,BULELENG,53830,SERIRIT,14950,23685,38635
53241,BALI,53814,BULELENG,53886,SUKASADA,12050,24730,36780
53241,BALI,53814,BULELENG,53961,TEJAKULA,4421,22360,26781
53241,BALI,53508,GIANYAR,53522,BLAHBATUH,9542,28930,38472
53241,BALI,53508,GIANYAR,53532,GIANYAR,13280,40808,54088
53241,BALI,53508,GIANYAR,53576,PAYANGAN,6592,20949,27541
53241,BALI,53508,GIANYAR,53509,SUKAWATI,11333,47388,58721
53241,BALI,53508,GIANYAR,53550,TAMPAKSIRING,5717,25216,30933
53241,BALI,53508,GIANYAR,53568,TEGALALLANG,8193,25905,34098
53241,BALI,53508,GIANYAR,53559,UBUD,9296,33929,43225
53241,BALI,53242,JEMBRANA,53288,JEMBRANA,10305,21480,31785
53241,BALI,53242,JEMBRANA,53277,MELAYA,9342,19691,29033
53241,BALI,53242,JEMBRANA,53256,MENDOYO,9256,26555,35811
53241,BALI,53242,JEMBRANA,53243,NEGARA,18440,26407,44847
53241,BALI,53242,JEMBRANA,53268,PEKUTATAN,5935,10668,16603
53241,BALI,53727,KARANGASEM,53771,ABANG,10958,25620,36578
53241,BALI,53727,KARANGASEM,53786,BEBANDEM,10830,18368,29198
53241,BALI,53727,KARANGASEM,53759,KARANGASEM,17124,31766,48890
53241,BALI,53727,KARANGASEM,53804,KUBU,12970,16822,29792
53241,BALI,53727,KARANGASEM,53746,MANGGIS,6901,18169,25070
53241,BALI,53727,KARANGASEM,53728,RENDANG,8907,14686,23593
53241,BALI,53727,KARANGASEM,53795,SELAT,7165,17980,25145
53241,BALI,53727,KARANGASEM,53735,SIDEMEN,5905,16453,22358
53241,BALI,53586,KLUNGKUNG,53604,BANJARANGKAN,6850,16632,23482
53241,BALI,53586,KLUNGKUNG,53637,DAWAN,5958,16010,21968
53241,BALI,53586,KLUNGKUNG,53618,KLUNGKUNG,10963,22422,33385
53241,BALI,53586,KLUNGKUNG,53587,NUSA PENIDA,12150,15767,27917
53241,BALI,53972,KOTA DENPASAR,53996,DENPASAR BARAT,26363,68230,94593
53241,BALI,53972,KOTA DENPASAR,53973,DENPASAR SELATAN,22047,63072,85119
53241,BALI,53972,KOTA DENPASAR,53984,DENPASAR TIMUR,12967,46845,59812
53241,BALI,53972,KOTA DENPASAR,54008,DENPASAR UTARA,18503,63473,81976
53241,BALI,53299,TABANAN,53412,BATURITI,9761,20496,30257
53241,BALI,53299,TABANAN,53361,KEDIRI,16087,34102,50189
53241,BALI,53299,TABANAN,53332,KERAMBITAN,8241,20049,28290
53241,BALI,53299,TABANAN,53377,MARGA,8134,21654,29788
53241,BALI,53299,TABANAN,53393,PENEBEL,10863,22707,33570
53241,BALI,53299,TABANAN,53425,PUPUAN,6225,21677,27902
53241,BALI,53299,TABANAN,53300,SELEMADEG,2096,13427,15523
53241,BALI,53299,TABANAN,53322,SELEMADEG BARAT,4062,10490,14552
53241,BALI,53299,TABANAN,53311,SELEMADEG TIMUR,4196,11969,16165
53241,BALI,53299,TABANAN,53348,TABANAN,12549,34325,46874
51578,BANTEN,53054,KOTA CILEGON,53055,CIBEBER,15916,11200,27116
51578,BANTEN,53054,KOTA CILEGON,53062,CILEGON,14216,8610,22826
51578,BANTEN,53054,KOTA CILEGON,53098,CITANGKIL,24153,13119,37272
51578,BANTEN,53054,KOTA CILEGON,53073,CIWANDAN,17696,7343,25039
51578,BANTEN,53054,KOTA CILEGON,53086,GEROGOL,14408,7491,21899
51578,BANTEN,53054,KOTA CILEGON,53080,JOMBANG,17258,15164,32422
51578,BANTEN,53054,KOTA CILEGON,53068,PULOMERAK,13529,10593,24122
51578,BANTEN,53054,KOTA CILEGON,53091,PURWAKARTA,14434,8388,22822
51578,BANTEN,53106,KOTA SERANG,53157,CIPOCOK JAYA,26411,16768,43179
51578,BANTEN,53106,KOTA SERANG,53146,CURUG,14319,10185,24504
51578,BANTEN,53106,KOTA SERANG,53120,KASEMEN,25699,18964,44663
51578,BANTEN,53106,KOTA SERANG,53107,SERANG,64458,45562,110020
51578,BANTEN,53106,KOTA SERANG,53166,TAKTAKAN,26277,15287,41564
51578,BANTEN,53106,KOTA SERANG,53131,WALANTAKA,25052,15256,40308
51578,BANTEN,52936,KOTA TANGERANG,52953,BATUCEPER,27323,20340,47663
51578,BANTEN,52936,KOTA TANGERANG,52961,BENDA,25208,18692,43900
51578,BANTEN,52936,KOTA TANGERANG,53010,CIBODAS,40032,34592,74624
51578,BANTEN,52936,KOTA TANGERANG,52978,CILEDUG,37918,33140,71058
51578,BANTEN,52936,KOTA TANGERANG,52967,CIPONDOH,58913,47285,106198
51578,BANTEN,52936,KOTA TANGERANG,52946,JATIUWUNG,35243,16181,51424
51578,BANTEN,52936,KOTA TANGERANG,53037,KARANG TENGAH,32147,29097,61244
51578,BANTEN,52936,KOTA TANGERANG,52987,KARAWACI,48089,46921,95010
51578,BANTEN,52936,KOTA TANGERANG,53045,LARANGAN,40981,41328,82309
51578,BANTEN,52936,KOTA TANGERANG,53017,NEGLASARI,28628,29040,57668
51578,BANTEN,52936,KOTA TANGERANG,53004,PERIUK,34094,32920,67014
51578,BANTEN,52936,KOTA TANGERANG,53025,PINANG,50422,33996,84418
51578,BANTEN,52936,KOTA TANGERANG,52937,TANGERANG,41589,41813,83402
51578,BANTEN,53179,KOTA TANGERANG SELATAN,53210,CIPUTAT,50840,55410,106250
51578,BANTEN,53179,KOTA TANGERANG SELATAN,53218,CIPUTAT TIMUR,45593,49146,94739
51578,BANTEN,53179,KOTA TANGERANG SELATAN,53225,PAMULANG,79800,82822,162622
51578,BANTEN,53179,KOTA TANGERANG SELATAN,53198,PONDOK AREN,76335,78592,154927
51578,BANTEN,53179,KOTA TANGERANG SELATAN,53180,SERPONG,34215,38978,73193
51578,BANTEN,53179,KOTA TANGERANG SELATAN,53190,SERPONG UTARA,28053,37231,65284
51578,BANTEN,53179,KOTA TANGERANG SELATAN,53234,SETU,21305,17609,38914
51578,BANTEN,51913,LEBAK,52017,BANJARSARI,15665,11109,26774
51578,BANTEN,51913,LEBAK,51941,BAYAH,11193,13468,24661
51578,BANTEN,51913,LEBAK,51994,BOJONGMANIK,5689,5934,11623
51578,BANTEN,51913,LEBAK,52155,CIBADAK,19314,10543,29857
51578,BANTEN,51913,LEBAK,52171,CIBEBER,13450,22294,35744
51578,BANTEN,51913,LEBAK,52277,CIGEMLONG,4146,7445,11591
51578,BANTEN,51913,LEBAK,52256,CIHARA,6347,9133,15480
51578,BANTEN,51913,LEBAK,52130,CIJAKU,6275,8044,14319
51578,BANTEN,51913,LEBAK,52141,CIKULUR,12433,9247,21680
51578,BANTEN,51913,LEBAK,52038,CILELES,11007,10858,21865
51578,BANTEN,51913,LEBAK,52194,CILOGRANG,9250,8418,17668
51578,BANTEN,51913,LEBAK,52051,CIMARGA,16815,13379,30194
51578,BANTEN,51913,LEBAK,51953,CIPANAS,15284,8145,23429
51578,BANTEN,51913,LEBAK,52266,CIRINTEN,7567,6169,13736
51578,BANTEN,51913,LEBAK,52230,CURUG BITUNG,6759,9342,16101
51578,BANTEN,51913,LEBAK,52004,GUNUNGKENCANA,9206,7864,17070
51578,BANTEN,51913,LEBAK,52241,KALANGANYAR,10134,5147,15281
51578,BANTEN,51913,LEBAK,52249,LEBAKGEDONG,5747,5835,11582
51578,BANTEN,51913,LEBAK,51981,LEUWIDAMAR,12332,10252,22584
51578,BANTEN,51913,LEBAK,52085,MAJA,16192,8555,24747
51578,BANTEN,51913,LEBAK,51914,MALINGPING,14752,15648,30400
51578,BANTEN,51913,LEBAK,51968,MUNCANG,9346,6712,16058
51578,BANTEN,51913,LEBAK,51929,PANGGARANGAN,9664,11490,21154
51578,BANTEN,51913,LEBAK,52100,RANGKASBITUNG,40613,24328,64941
51578,BANTEN,51913,LEBAK,52069,SAJIRA,14681,8501,23182
51578,BANTEN,51913,LEBAK,52219,SOBANG,7063,9692,16755
51578,BANTEN,51913,LEBAK,52205,WANASALAM,11197,13744,24941
51578,BANTEN,51913,LEBAK,52117,WARUNGGUNUNG,15579,9572,25151
51578,BANTEN,51579,PANDEGLANG,51643,ANGSANA,6105,7671,13776
51578,BANTEN,51579,PANDEGLANG,51796,BANJAR,9541,5456,14997
51578,BANTEN,51579,PANDEGLANG,51677,BOJONG,10868,5834,16702
51578,BANTEN,51579,PANDEGLANG,51813,CADASARI,11948,4479,16427
51578,BANTEN,51579,PANDEGLANG,51872,CARITA,9244,8676,17920
51578,BANTEN,51579,PANDEGLANG,51601,CIBALIUNG,6012,8110,14122
51578,BANTEN,51579,PANDEGLANG,51861,CIBITUNG,5140,5657,10797
51578,BANTEN,51579,PANDEGLANG,51626,CIGEULIS,7566,10590,18156
51578,BANTEN,51579,PANDEGLANG,51850,CIKEDAL,10915,5759,16674
51578,BANTEN,51579,PANDEGLANG,51611,CIKEUSIK,11525,15178,26703
51578,BANTEN,51579,PANDEGLANG,51588,CIMANGGU,7732,12702,20434
51578,BANTEN,51579,PANDEGLANG,51773,CIMANUK,13790,4769,18559
51578,BANTEN,51579,PANDEGLANG,51732,CIPEUCANG,8987,3732,12719
51578,BANTEN,51579,PANDEGLANG,51825,CISATA,9683,2455,12138
51578,BANTEN,51579,PANDEGLANG,51743,JIPUT,11277,4758,16035
51578,BANTEN,51579,PANDEGLANG,51785,KADUHEJO,13538,4326,17864
51578,BANTEN,51579,PANDEGLANG,51845,KARANG TANJUNG,12399,5679,18078
51578,BANTEN,51579,PANDEGLANG,83879,KORONCONG,6129,3073,9202
51578,BANTEN,51579,PANDEGLANG,51695,LABUAN,15326,12021,27347
51578,BANTEN,51579,PANDEGLANG,83880,MAJASARI,17833,5918,23751
51578,BANTEN,51579,PANDEGLANG,51757,MANDALAWANGI,16404,6987,23391
51578,BANTEN,51579,PANDEGLANG,51894,MEKARJAYA,5278,4214,9492
51578,BANTEN,51579,PANDEGLANG,51705,MENES,14142,4274,18416
51578,BANTEN,51579,PANDEGLANG,51653,MUNJUL,7005,5584,12589
51578,BANTEN,51579,PANDEGLANG,51663,PAGELARAN,11501,6863,18364
51578,BANTEN,51579,PANDEGLANG,51808,PANDEGLANG,16470,6766,23236
51578,BANTEN,51579,PANDEGLANG,51636,PANIMBANG,9401,15941,25342
51578,BANTEN,51579,PANDEGLANG,51835,PATIA,7040,6279,13319
51578,BANTEN,51579,PANDEGLANG,51686,PICUNG,10398,6266,16664
51578,BANTEN,51579,PANDEGLANG,83878,PULOSARI,9049,4253,13302
51578,BANTEN,51579,PANDEGLANG,51717,SAKETI,13977,6920,20897
51578,BANTEN,51579,PANDEGLANG,51903,SINDANGRESMI,6020,5343,11363
51578,BANTEN,51579,PANDEGLANG,83881,SOBANG,7257,12555,19812
51578,BANTEN,51579,PANDEGLANG,51883,SUKARESMI,7632,9595,17227
51578,BANTEN,51579,PANDEGLANG,51580,SUMUR,5055,6898,11953
51578,BANTEN,52593,SERANG,52880,ANYAR,16989,11387,28376
51578,BANTEN,52593,SERANG,52927,BANDUNG,9904,6766,16670
51578,BANTEN,52593,SERANG,52783,BAROS,17315,7295,24610
51578,BANTEN,52593,SERANG,52751,BINUANG,10907,5231,16138
51578,BANTEN,52593,SERANG,52622,BOJONEGARA,15047,9288,24335
51578,BANTEN,52593,SERANG,52740,CARENANG,13879,4422,18301
51578,BANTEN,52593,SERANG,52717,CIKANDE,32217,17611,49828
51578,BANTEN,52593,SERANG,52798,CIKEUSAL,21699,13006,34705
51578,BANTEN,52593,SERANG,52891,CINANGKA,16585,11976,28561
51578,BANTEN,52593,SERANG,52845,CIOMAS,12340,5931,18271
51578,BANTEN,52593,SERANG,52643,CIRUAS,25889,14344,40233
51578,BANTEN,52593,SERANG,52919,GUNUNG SARI,5421,3132,8553
51578,BANTEN,52593,SERANG,52835,JAWILAN,19192,8234,27426
51578,BANTEN,52593,SERANG,52730,KIBIN,18502,10851,29353
51578,BANTEN,52593,SERANG,52824,KOPO,16607,7425,24032
51578,BANTEN,52593,SERANG,52661,KRAGILAN,23628,12761,36389
51578,BANTEN,52593,SERANG,52594,KRAMATWATU,31836,18045,49881
51578,BANTEN,52593,SERANG,83885,LEBAK WANGI,12980,6254,19234
51578,BANTEN,52593,SERANG,52905,MANCAK,13335,7734,21069
51578,BANTEN,52593,SERANG,52857,PABUARAN,12377,7764,20141
51578,BANTEN,52593,SERANG,52865,PADARINCANG,18270,11529,29799
51578,BANTEN,52593,SERANG,52814,PAMARAYAN,12101,12684,24785
51578,BANTEN,52593,SERANG,52759,PETIR,14918,10299,25217
51578,BANTEN,52593,SERANG,52676,PONTANG,13612,8276,21888
51578,BANTEN,52593,SERANG,52633,PULO AMPEL,13291,6633,19924
51578,BANTEN,52593,SERANG,52707,TANARA,15799,4281,20080
51578,BANTEN,52593,SERANG,52692,TIRTAYASA,13676,8001,21677
51578,BANTEN,52593,SERANG,52773,TUNJUNG TEJA,12568,7453,20021
51578,BANTEN,52593,SERANG,52610,WARINGINKURUNG,12661,8050,20711
51578,BANTEN,52287,TANGERANG,52288,BALARAJA,39104,18981,58085
51578,BANTEN,52287,TANGERANG,52478,CIKUPA,63493,32222,95715
51578,BANTEN,52287,TANGERANG,52526,CISAUK,20048,16854,36902
51578,BANTEN,52287,TANGERANG,52333,CISOKA,25126,16221,41347
51578,BANTEN,52287,TANGERANG,52470,CURUG,44755,33089,77844
51578,BANTEN,52287,TANGERANG,52574,GUNUNG KALER,13826,11073,24899
51578,BANTEN,52287,TANGERANG,52322,JAMBE,15012,9144,24156
51578,BANTEN,52287,TANGERANG,52298,JAYANTI,20691,9887,30578
51578,BANTEN,52287,TANGERANG,52542,KELAPA DUA,40733,46848,87581
51578,BANTEN,52287,TANGERANG,52380,KEMIRI,12979,8209,21188
51578,BANTEN,52287,TANGERANG,52435,KOSAMBI,25108,35506,60614
51578,BANTEN,52287,TANGERANG,52344,KRESEK,22182,12108,34290
51578,BANTEN,52287,TANGERANG,52355,KRONJO,19026,11861,30887
51578,BANTEN,52287,TANGERANG,52502,LEGOK,32888,20300,53188
51578,BANTEN,52287,TANGERANG,52367,MAUK,30769,13589,44358
51578,BANTEN,52287,TANGERANG,52584,MEKAR BARU,11270,8124,19394
51578,BANTEN,52287,TANGERANG,52514,PAGEDANGAN,29536,18646,48182
51578,BANTEN,52287,TANGERANG,52446,PAKUHAJI,33985,26880,60865
51578,BANTEN,52287,TANGERANG,52493,PANONGAN,31391,22998,54389
51578,BANTEN,52287,TANGERANG,52411,PASAR KEMIS,69213,57309,126522
51578,BANTEN,52287,TANGERANG,52397,RAJEG,45269,27902,73171
51578,BANTEN,52287,TANGERANG,52461,SEPATAN,32779,16584,49363
51578,BANTEN,52287,TANGERANG,52557,SEPATAN TIMUR,26998,16633,43631
51578,BANTEN,52287,TANGERANG,52549,SINDANG JAYA,27342,14178,41520
51578,BANTEN,52287,TANGERANG,52566,SOLEAR,20497,17170,37667
51578,BANTEN,52287,TANGERANG,52388,SUKADIRI,22560,9933,32493
51578,BANTEN,52287,TANGERANG,52533,SUKAMULYA,23353,10793,34146
51578,BANTEN,52287,TANGERANG,52421,TELUKNAGA,38693,38334,77027
51578,BANTEN,52287,TANGERANG,52307,TIGARAKSA,40059,25080,65139
20802,BENGKULU,20923,BENGKULU SELATAN,21050,AIR NIPIS,1575,3472,5047
20802,BENGKULU,20923,BENGKULU SELATAN,21072,BUNGA MAS,1175,2145,3320
20802,BENGKULU,20923,BENGKULU SELATAN,20924,KEDURANG,2269,3389,5658
20802,BENGKULU,20923,BENGKULU SELATAN,21037,KEDURANG ILIR,1163,2962,4125
20802,BENGKULU,20923,BENGKULU SELATAN,21003,KOTA MANNA,7696,6787,14483
20802,BENGKULU,20923,BENGKULU SELATAN,20984,MANNA,3045,3989,7034
20802,BENGKULU,20923,BENGKULU SELATAN,21083,PASAR MANNA,5237,3726,8963
20802,BENGKULU,20923,BENGKULU SELATAN,20967,PINO,2357,3805,6162
20802,BENGKULU,20923,BENGKULU SELATAN,21015,PINO RAYA,2893,6548,9441
20802,BENGKULU,20923,BENGKULU SELATAN,20944,SEGINIM,2195,5529,7724
20802,BENGKULU,20923,BENGKULU SELATAN,21061,ULU MANNA,1549,2612,4161
20802,BENGKULU,20803,BENGKULU TENGAH,83435,BANG HAJI,1321,1839,3160
20802,BENGKULU,20803,BENGKULU TENGAH,20804,KARANG TINGGI,3222,4033,7255
20802,BENGKULU,20803,BENGKULU TENGAH,83432,MERIGI KELINDANG,1939,1992,3931
20802,BENGKULU,20803,BENGKULU TENGAH,83433,MERIGI SAKTI,1680,1577,3257
20802,BENGKULU,20803,BENGKULU TENGAH,20877,PAGAR JATI,2139,1495,3634
20802,BENGKULU,20803,BENGKULU TENGAH,20856,PEMATANG TIGA,1688,2119,3807
20802,BENGKULU,20803,BENGKULU TENGAH,20832,PONDOK KELAPA,6299,9254,15553
20802,BENGKULU,20803,BENGKULU TENGAH,83434,PONDOK KUBANG,1887,3093,4980
20802,BENGKULU,20803,BENGKULU TENGAH,20899,TABA PENANJUNG,3001,3085,6086
20802,BENGKULU,20803,BENGKULU TENGAH,20818,TALANG EMPAT,2864,5044,7908
20802,BENGKULU,21265,BENGKULU UTARA,21456,AIR BESI,1836,3124,4960
20802,BENGKULU,21265,BENGKULU UTARA,21474,AIR NAPAL,2130,3141,5271
20802,BENGKULU,21265,BENGKULU UTARA,83439,AIR PADANG,1053,2189,3242
20802,BENGKULU,21265,BENGKULU UTARA,21309,ARGA MAKMUR,10570,9445,20015
20802,BENGKULU,21265,BENGKULU UTARA,83497,ARMA JAYA,2495,3498,5993
20802,BENGKULU,21265,BENGKULU UTARA,21380,BATIK NAU,1904,5531,7435
20802,BENGKULU,21265,BENGKULU UTARA,21266,ENGGANO,353,1119,1472
20802,BENGKULU,21265,BENGKULU UTARA,21339,GIRI MULYA,2545,6080,8625
20802,BENGKULU,21265,BENGKULU UTARA,83438,HULU PALIK,2153,3535,5688
20802,BENGKULU,21265,BENGKULU UTARA,21273,KERKAP,2733,3738,6471
20802,BENGKULU,21265,BENGKULU UTARA,21396,KETAHUN,7423,16588,24011
20802,BENGKULU,21265,BENGKULU UTARA,21356,LAIS,2630,4121,6751
20802,BENGKULU,21265,BENGKULU UTARA,21417,NAPAL PUTIH,1468,2589,4057
20802,BENGKULU,21265,BENGKULU UTARA,21345,PADANG JAYA,6005,10204,16209
20802,BENGKULU,21265,BENGKULU UTARA,21436,PUTRI HIJAU,6189,14071,20260
20802,BENGKULU,21265,BENGKULU UTARA,84087,TANJUNGAGUNG PALIK,1617,2626,4243
20802,BENGKULU,21265,BENGKULU UTARA,83499,ULOK KUPAI,2321,3735,6056
20802,BENGKULU,21492,KAUR,21551,KAUR SELATAN,4352,4152,8504
20802,BENGKULU,21492,KAUR,21541,KAUR TENGAH,1791,1031,2822
20802,BENGKULU,21492,KAUR,21529,KAUR UTARA,1593,1757,3350
20802,BENGKULU,21492,KAUR,21623,KELAM TENGAH,1477,1930,3407
20802,BENGKULU,21492,KAUR,21493,KINAL,1295,1452,2747
20802,BENGKULU,21492,KAUR,21637,LUAS,1594,1476,3070
20802,BENGKULU,21492,KAUR,21670,LUNGKANG KULE,848,884,1732
20802,BENGKULU,21492,KAUR,21571,MAJE,2040,5192,7232
20802,BENGKULU,21492,KAUR,21649,MUARA SAHUNG,1405,2251,3656
20802,BENGKULU,21492,KAUR,21591,NASAL,2242,5688,7930
20802,BENGKULU,21492,KAUR,21680,PADANG GUCI HILIR,774,1176,1950
20802,BENGKULU,21492,KAUR,21690,PADANG GUCI HULU,1630,1486,3116
20802,BENGKULU,21492,KAUR,21609,SEMIDANG GUMAY,1509,1902,3411
20802,BENGKULU,21492,KAUR,21508,TANJUNG KEMUNING,2047,3866,5913
20802,BENGKULU,21492,KAUR,21657,TETAP,1648,2213,3861
20802,BENGKULU,22135,KEPAHIANG,22136,BERMANI ILIR,4707,3749,8456
20802,BENGKULU,22135,KEPAHIANG,22215,KEBAWETAN,2751,4037,6788
20802,BENGKULU,22135,KEPAHIANG,22187,KEPAHIANG,11782,8776,20558
20802,BENGKULU,22135,KEPAHIANG,22206,MERIGI,3112,2074,5186
20802,BENGKULU,22135,KEPAHIANG,22241,MUARA KEMUMU,7875,4840,12715
20802,BENGKULU,22135,KEPAHIANG,22230,SEBERANG MUSI,1848,2038,3886
20802,BENGKULU,22135,KEPAHIANG,22172,TEBAT KARAI,3908,2894,6802
20802,BENGKULU,22135,KEPAHIANG,22154,UJAN MAS,5854,4247,10101
20802,BENGKULU,22252,KOTA BENGKULU,22260,GADING CEMPAKA,11391,9534,20925
20802,BENGKULU,22252,KOTA BENGKULU,22294,KAMPUNG MELAYU,5941,10124,16065
20802,BENGKULU,22252,KOTA BENGKULU,22286,MUARA BANGKA HULU,8978,9713,18691
20802,BENGKULU,22252,KOTA BENGKULU,22301,RATU AGUNG,13362,12179,25541
20802,BENGKULU,22252,KOTA BENGKULU,22310,RATU SAMBAN,6364,5628,11992
20802,BENGKULU,22252,KOTA BENGKULU,22253,SELEBAR,13191,14343,27534
20802,BENGKULU,22252,KOTA BENGKULU,83447,SINGARAN PATI,9676,10109,19785
20802,BENGKULU,22252,KOTA BENGKULU,22320,SUNGAI SERUT,5649,5477,11126
20802,BENGKULU,22252,KOTA BENGKULU,22272,TELUK SEGARA,6580,6028,12608
20802,BENGKULU,22052,LEBONG,83444,AMEN,1926,2189,4115
20802,BENGKULU,22052,LEBONG,83441,BINGIN KUNING,2134,3030,5164
20802,BENGKULU,22052,LEBONG,22093,LEBONG ATAS,1292,3201,4493
20802,BENGKULU,22052,LEBONG,83442,LEBONG SAKTI,2144,2533,4677
20802,BENGKULU,22052,LEBONG,22063,LEBONG SELATAN,2948,4071,7019
20802,BENGKULU,22052,LEBONG,22080,LEBONG TENGAH,2062,2699,4761
20802,BENGKULU,22052,LEBONG,22106,LEBONG UTARA,3685,4223,7908
20802,BENGKULU,22052,LEBONG,83443,PELABAI,1106,1841,2947
20802,BENGKULU,22052,LEBONG,83446,PINANG BELAPIS,947,1572,2519
20802,BENGKULU,22052,LEBONG,22053,RIMBO PENGADANG,1015,1395,2410
20802,BENGKULU,22052,LEBONG,83440,TOPOS,2179,1273,3452
20802,BENGKULU,22052,LEBONG,83445,URAM JAYA,1497,1342,2839
20802,BENGKULU,21885,MUKOMUKO,22034,AIR DIKIT,1341,1969,3310
20802,BENGKULU,21885,MUKOMUKO,22025,AIR MAJUNTO,1735,4048,5783
20802,BENGKULU,21885,MUKOMUKO,21950,AIR RAMI,2532,3746,6278
20802,BENGKULU,21885,MUKOMUKO,21925,IPUH,4599,3303,7902
20802,BENGKULU,21885,MUKOMUKO,21894,KOTA MUKOMUKO,4087,3800,7887
20802,BENGKULU,21885,MUKOMUKO,21886,LUBUK PINANG,2938,3605,6543
20802,BENGKULU,21885,MUKOMUKO,21942,MALIN DEMAN,1470,1569,3039
20802,BENGKULU,21885,MUKOMUKO,21990,PENARIK,3657,8469,12126
20802,BENGKULU,21885,MUKOMUKO,21913,PONDOK SUGUH,2448,2910,5358
20802,BENGKULU,21885,MUKOMUKO,21977,SELAGAN RAYA,1587,2072,3659
20802,BENGKULU,21885,MUKOMUKO,22042,SUNGAI RUMBAI,1409,2936,4345
20802,BENGKULU,21885,MUKOMUKO,21963,TERAMANG JAYA,2115,3210,5325
20802,BENGKULU,21885,MUKOMUKO,21904,TERAS TERUNJAM,1292,2426,3718
20802,BENGKULU,21885,MUKOMUKO,22014,V KOTO,1560,1682,3242
20802,BENGKULU,21885,MUKOMUKO,22005,XIV KOTO,2269,3886,6155
20802,BENGKULU,21093,REJANG LEBONG,21144,BERMANI ULU,3445,3253,6698
20802,BENGKULU,21093,REJANG LEBONG,21254,BERMANI ULU RAYA,2640,3001,5641
20802,BENGKULU,21093,REJANG LEBONG,21220,BINDURIANG,2024,2934,4958
20802,BENGKULU,21093,REJANG LEBONG,21134,CURUP,9087,5179,14266
20802,BENGKULU,21093,REJANG LEBONG,21197,CURUP SELATAN,6994,3052,10046
20802,BENGKULU,21093,REJANG LEBONG,21209,CURUP TENGAH,10518,6393,16911
20802,BENGKULU,21093,REJANG LEBONG,21187,CURUP TIMUR,6122,4478,10600
20802,BENGKULU,21093,REJANG LEBONG,21172,CURUP UTARA,4986,3406,8392
20802,BENGKULU,21093,REJANG LEBONG,21094,KOTA PADANG,2936,2311,5247
20802,BENGKULU,21093,REJANG LEBONG,21105,PADANG ULAK TANDING,4389,5104,9493
20802,BENGKULU,21093,REJANG LEBONG,21157,SELUPU REJANG,8279,7672,15951
20802,BENGKULU,21093,REJANG LEBONG,21243,SINDANG BELITI ILIR,2523,1889,4412
20802,BENGKULU,21093,REJANG LEBONG,21226,SINDANG BELITI ULU,3196,2775,5971
20802,BENGKULU,21093,REJANG LEBONG,21236,SINDANG DATARAN,2372,3168,5540
20802,BENGKULU,21093,REJANG LEBONG,21121,SINDANG KELINGI,3968,4448,8416
20802,BENGKULU,21702,SELUMA,21787,AIR PERIUKAN,3396,8103,11499
20802,BENGKULU,21702,SELUMA,21872,ILIR TALO,3446,4100,7546
20802,BENGKULU,21702,SELUMA,21800,LUBUK SANDI,2958,3066,6024
20802,BENGKULU,21702,SELUMA,21722,SELUMA,2107,2253,4360
20802,BENGKULU,21702,SELUMA,21813,SELUMA BARAT,1653,3074,4727
20802,BENGKULU,21702,SELUMA,21840,SELUMA SELATAN,2511,3843,6354
20802,BENGKULU,21702,SELUMA,21822,SELUMA TIMUR,2398,2652,5050
20802,BENGKULU,21702,SELUMA,21831,SELUMA UTARA,3101,2237,5338
20802,BENGKULU,21702,SELUMA,21745,SEMIDANG ALAS,2385,4503,6888
20802,BENGKULU,21702,SELUMA,21766,SEMIDANG ALAS MARAS,4585,6452,11037
20802,BENGKULU,21702,SELUMA,21703,SUKARAJA,5255,11794,17049
20802,BENGKULU,21702,SELUMA,21730,TALO,3001,2607,5608
20802,BENGKULU,21702,SELUMA,21852,TALO KECIL,1975,2843,4818
20802,BENGKULU,21702,SELUMA,21862,ULU TALO,1116,2004,3120
41863,DAERAH ISTIMEWA YOGYAKARTA,41965,BANTUL,41984,BAMBANGLIPURO,11585,14330,25915
41863,DAERAH ISTIMEWA YOGYAKARTA,41965,BANTUL,42024,BANGUNTAPAN,31177,35058,66235
41863,DAERAH ISTIMEWA YOGYAKARTA,41965,BANTUL,41997,BANTUL,18303,21892,40195
41863,DAERAH ISTIMEWA YOGYAKARTA,41965,BANTUL,42017,DLINGO,8570,15742,24312
41863,DAERAH ISTIMEWA YOGYAKARTA,41965,BANTUL,42008,IMOGIRI,17068,21086,38154
41863,DAERAH ISTIMEWA YOGYAKARTA,41965,BANTUL,42003,JETIS,16802,19291,36093
41863,DAERAH ISTIMEWA YOGYAKARTA,41965,BANTUL,42048,KASIHAN,29222,35376,64598
41863,DAERAH ISTIMEWA YOGYAKARTA,41965,BANTUL,41974,KRETEK,9583,9976,19559
41863,DAERAH ISTIMEWA YOGYAKARTA,41965,BANTUL,41993,PAJANGAN,11335,10788,22123
41863,DAERAH ISTIMEWA YOGYAKARTA,41965,BANTUL,41988,PANDAK,14072,19020,33092
41863,DAERAH ISTIMEWA YOGYAKARTA,41965,BANTUL,42039,PIYUNGAN,14949,17163,32112
41863,DAERAH ISTIMEWA YOGYAKARTA,41965,BANTUL,42033,PLERET,14595,14050,28645
41863,DAERAH ISTIMEWA YOGYAKARTA,41965,BANTUL,41980,PUNDONG,9925,12392,22317
41863,DAERAH ISTIMEWA YOGYAKARTA,41965,BANTUL,41969,SANDEN,11478,9242,20720
41863,DAERAH ISTIMEWA YOGYAKARTA,41965,BANTUL,42053,SEDAYU,16185,13078,29263
41863,DAERAH ISTIMEWA YOGYAKARTA,41965,BANTUL,42043,SEWON,27703,34081,61784
41863,DAERAH ISTIMEWA YOGYAKARTA,41965,BANTUL,41966,SRANDAKAN,8983,10818,19801
41863,DAERAH ISTIMEWA YOGYAKARTA,42058,GUNUNGKIDUL,42184,GEDANGSARI,5959,15997,21956
41863,DAERAH ISTIMEWA YOGYAKARTA,42058,GUNUNGKIDUL,42200,GIRISUBO,5073,10338,15411
41863,DAERAH ISTIMEWA YOGYAKARTA,42058,GUNUNGKIDUL,42135,KARANGMOJO,11499,21820,33319
41863,DAERAH ISTIMEWA YOGYAKARTA,42058,GUNUNGKIDUL,42177,NGAWEN,5269,15028,20297
41863,DAERAH ISTIMEWA YOGYAKARTA,42058,GUNUNGKIDUL,42074,NGLIPAR,8779,10825,19604
41863,DAERAH ISTIMEWA YOGYAKARTA,42058,GUNUNGKIDUL,42108,PALIYAN,9713,9452,19165
41863,DAERAH ISTIMEWA YOGYAKARTA,42058,GUNUNGKIDUL,42116,PANGGANG,8173,9669,17842
41863,DAERAH ISTIMEWA YOGYAKARTA,42058,GUNUNGKIDUL,42096,PATUK,9112,11423,20535
41863,DAERAH ISTIMEWA YOGYAKARTA,42058,GUNUNGKIDUL,42082,PLAYEN,14709,22005,36714
41863,DAERAH ISTIMEWA YOGYAKARTA,42058,GUNUNGKIDUL,42145,PONJONG,11529,22255,33784
41863,DAERAH ISTIMEWA YOGYAKARTA,42058,GUNUNGKIDUL,42215,PURWOSARI,5972,6697,12669
41863,DAERAH ISTIMEWA YOGYAKARTA,42058,GUNUNGKIDUL,42157,RONGKOP,5673,13179,18852
41863,DAERAH ISTIMEWA YOGYAKARTA,42058,GUNUNGKIDUL,42192,SAPTOSARI,12112,11430,23542
41863,DAERAH ISTIMEWA YOGYAKARTA,42058,GUNUNGKIDUL,42129,SEMANU,13007,23330,36337
41863,DAERAH ISTIMEWA YOGYAKARTA,42058,GUNUNGKIDUL,42166,SEMIN,9097,23175,32272
41863,DAERAH ISTIMEWA YOGYAKARTA,42058,GUNUNGKIDUL,42209,TANJUNGSARI,8243,10562,18805
41863,DAERAH ISTIMEWA YOGYAKARTA,42058,GUNUNGKIDUL,42123,TEPUS,10484,11824,22308
41863,DAERAH ISTIMEWA YOGYAKARTA,42058,GUNUNGKIDUL,42059,WONOSARI,22398,31101,53499
41863,DAERAH ISTIMEWA YOGYAKARTA,42325,KOTA YOGYAKARTA,42341,DANUREJAN,4581,8127,12708
41863,DAERAH ISTIMEWA YOGYAKARTA,42325,KOTA YOGYAKARTA,42345,GEDONGTENGEN,3465,8842,12307
41863,DAERAH ISTIMEWA YOGYAKARTA,42325,KOTA YOGYAKARTA,42335,GONDOKUSUMAN,8896,17113,26009
41863,DAERAH ISTIMEWA YOGYAKARTA,42325,KOTA YOGYAKARTA,42363,GONDOMANAN,3646,5848,9494
41863,DAERAH ISTIMEWA YOGYAKARTA,42325,KOTA YOGYAKARTA,42331,JETIS,5224,11152,16376
41863,DAERAH ISTIMEWA YOGYAKARTA,42325,KOTA YOGYAKARTA,42381,KOTAGEDE,10404,9285,19689
41863,DAERAH ISTIMEWA YOGYAKARTA,42325,KOTA YOGYAKARTA,42359,KRATON,5407,7760,13167
41863,DAERAH ISTIMEWA YOGYAKARTA,42325,KOTA YOGYAKARTA,42355,MANTRIJERON,8782,12333,21115
41863,DAERAH ISTIMEWA YOGYAKARTA,42325,KOTA YOGYAKARTA,42369,MERGANGSAN,7990,11255,19245
41863,DAERAH ISTIMEWA YOGYAKARTA,42325,KOTA YOGYAKARTA,42348,NGAMPILAN,4916,6038,10954
41863,DAERAH ISTIMEWA YOGYAKARTA,42325,KOTA YOGYAKARTA,42366,PAKUALAMAN,2362,4628,6990
41863,DAERAH ISTIMEWA YOGYAKARTA,42325,KOTA YOGYAKARTA,42326,TEGALREJO,7783,14307,22090
41863,DAERAH ISTIMEWA YOGYAKARTA,42325,KOTA YOGYAKARTA,42373,UMBULHARJO,18563,21583,40146
41863,DAERAH ISTIMEWA YOGYAKARTA,42325,KOTA YOGYAKARTA,42351,WIROBRAJAN,6422,9629,16051
41863,DAERAH ISTIMEWA YOGYAKARTA,41864,KULON PROGO,41902,GALUR,10959,9078,20037
41863,DAERAH ISTIMEWA YOGYAKARTA,41864,KULON PROGO,41940,GIRIMULYO,6704,8515,15219
41863,DAERAH ISTIMEWA YOGYAKARTA,41864,KULON PROGO,41960,KALIBAWANG,8069,10190,18259
41863,DAERAH ISTIMEWA YOGYAKARTA,41864,KULON PROGO,41934,KOKAP,9084,12178,21262
41863,DAERAH ISTIMEWA YOGYAKARTA,41864,KULON PROGO,41910,LENDAH,12493,12934,25427
41863,DAERAH ISTIMEWA YOGYAKARTA,41864,KULON PROGO,41945,NANGGULAN,9414,9160,18574
41863,DAERAH ISTIMEWA YOGYAKARTA,41864,KULON PROGO,41890,PANJATAN,11131,11557,22688
41863,DAERAH ISTIMEWA YOGYAKARTA,41864,KULON PROGO,41926,PENGASIH,14963,15224,30187
41863,DAERAH ISTIMEWA YOGYAKARTA,41864,KULON PROGO,41952,SAMIGALUH,7711,9633,17344
41863,DAERAH ISTIMEWA YOGYAKARTA,41864,KULON PROGO,41917,SENTOLO,14700,15069,29769
41863,DAERAH ISTIMEWA YOGYAKARTA,41864,KULON PROGO,41865,TEMON,8037,8308,16345
41863,DAERAH ISTIMEWA YOGYAKARTA,41864,KULON PROGO,41881,WATES,13880,15035,28915
41863,DAERAH ISTIMEWA YOGYAKARTA,42221,SLEMAN,42263,BERBAH,14513,17812,32325
41863,DAERAH ISTIMEWA YOGYAKARTA,42221,SLEMAN,42319,CANGKRINGAN,9108,10086,19194
41863,DAERAH ISTIMEWA YOGYAKARTA,42221,SLEMAN,42259,DEPOK,30186,48189,78375
41863,DAERAH ISTIMEWA YOGYAKARTA,42221,SLEMAN,42222,GAMPING,25451,31468,56919
41863,DAERAH ISTIMEWA YOGYAKARTA,42221,SLEMAN,42228,GODEAN,20653,22478,43131
41863,DAERAH ISTIMEWA YOGYAKARTA,42221,SLEMAN,42275,KALASAN,19563,28393,47956
41863,DAERAH ISTIMEWA YOGYAKARTA,42221,SLEMAN,42241,MINGGIR,10452,10471,20923
41863,DAERAH ISTIMEWA YOGYAKARTA,42221,SLEMAN,42253,MLATI,24638,33318,57956
41863,DAERAH ISTIMEWA YOGYAKARTA,42221,SLEMAN,42236,MOYUDAN,13727,8127,21854
41863,DAERAH ISTIMEWA YOGYAKARTA,42221,SLEMAN,42286,NGAGLIK,24966,33453,58419
41863,DAERAH ISTIMEWA YOGYAKARTA,42221,SLEMAN,42280,NGEMPLAK,17016,20268,37284
41863,DAERAH ISTIMEWA YOGYAKARTA,42221,SLEMAN,42313,PAKEM,10709,12803,23512
41863,DAERAH ISTIMEWA YOGYAKARTA,42221,SLEMAN,42268,PRAMBANAN,15005,17018,32023
41863,DAERAH ISTIMEWA YOGYAKARTA,42221,SLEMAN,42247,SEYEGAN,15947,15002,30949
41863,DAERAH ISTIMEWA YOGYAKARTA,42221,SLEMAN,42293,SLEMAN,20163,21812,41975
41863,DAERAH ISTIMEWA YOGYAKARTA,42221,SLEMAN,42299,TEMPEL,18729,14968,33697
41863,DAERAH ISTIMEWA YOGYAKARTA,42221,SLEMAN,42308,TURI,12594,10309,22903
25823,DKI JAKARTA,25924,JAKARTA BARAT,25925,CENGKARENG,93992,169742,263734
25823,DKI JAKARTA,25924,JAKARTA BARAT,25932,GROGOL PETAMBURAN,34891,89315,124206
25823,DKI JAKARTA,25924,JAKARTA BARAT,25969,KALIDERES,82413,117760,200173
25823,DKI JAKARTA,25924,JAKARTA BARAT,25961,KEBON JERUK,81193,94976,176169
25823,DKI JAKARTA,25924,JAKARTA BARAT,25982,KEMBANGAN,61233,79413,140646
25823,DKI JAKARTA,25924,JAKARTA BARAT,25975,PAL MERAH,56840,56627,113467
25823,DKI JAKARTA,25924,JAKARTA BARAT,25940,TAMAN SARI,22009,46806,68815
25823,DKI JAKARTA,25924,JAKARTA BARAT,25949,TAMBORA,47244,87464,134708
25823,DKI JAKARTA,25833,JAKARTA PUSAT,25863,CEMPAKA PUTIH,26630,26216,52846
25823,DKI JAKARTA,25833,JAKARTA PUSAT,25834,GAMBIR,20496,30787,51283
25823,DKI JAKARTA,25833,JAKARTA PUSAT,25881,JOHAR BARU,33646,36654,70300
25823,DKI JAKARTA,25833,JAKARTA PUSAT,25847,KEMAYORAN,57222,70723,127945
25823,DKI JAKARTA,25833,JAKARTA PUSAT,25867,MENTENG,24676,22392,47068
25823,DKI JAKARTA,25833,JAKARTA PUSAT,25841,SAWAH BESAR,20833,46016,66849
25823,DKI JAKARTA,25833,JAKARTA PUSAT,25856,SENEN,31210,33278,64488
25823,DKI JAKARTA,25833,JAKARTA PUSAT,25873,TANAH ABANG,44003,42600,86603
25823,DKI JAKARTA,25989,JAKARTA SELATAN,26028,CILANDAK,53703,59416,113119
25823,DKI JAKARTA,25989,JAKARTA SELATAN,26052,JAGAKARSA,93772,74947,168719
25823,DKI JAKARTA,25989,JAKARTA SELATAN,26034,KEBAYORAN BARU,37528,46443,83971
25823,DKI JAKARTA,25989,JAKARTA SELATAN,26021,KEBAYORAN LAMA,76241,84957,161198
25823,DKI JAKARTA,25989,JAKARTA SELATAN,26007,MAMPANG PRAPATAN,46816,37005,83821
25823,DKI JAKARTA,25989,JAKARTA SELATAN,26045,PANCORAN,53147,36630,89777
25823,DKI JAKARTA,25989,JAKARTA SELATAN,26013,PASAR MINGGU,85216,78402,163618
25823,DKI JAKARTA,25989,JAKARTA SELATAN,26059,PESANGGRAHAN,60660,62202,122862
25823,DKI JAKARTA,25989,JAKARTA SELATAN,25998,SETIABUDI,32339,32354,64693
25823,DKI JAKARTA,25989,JAKARTA SELATAN,25990,TEBET,73056,56072,129128
25823,DKI JAKARTA,26065,JAKARTA TIMUR,26104,CAKUNG,140363,112921,253284
25823,DKI JAKARTA,26065,JAKARTA TIMUR,26132,CIPAYUNG,72928,56525,129453
25823,DKI JAKARTA,26065,JAKARTA TIMUR,26126,CIRACAS,78752,69201,147953
25823,DKI JAKARTA,26065,JAKARTA TIMUR,26112,DUREN SAWIT,117132,105800,222932
25823,DKI JAKARTA,26065,JAKARTA TIMUR,26081,JATINEGARA,91053,82591,173644
25823,DKI JAKARTA,26065,JAKARTA TIMUR,26090,KRAMATJATI,84430,65653,150083
25823,DKI JAKARTA,26065,JAKARTA TIMUR,26120,MAKASAR,56742,51362,108104
25823,DKI JAKARTA,26065,JAKARTA TIMUR,26066,MATRAMAN,51239,45677,96916
25823,DKI JAKARTA,26065,JAKARTA TIMUR,26098,PASAR REBO,61182,45274,106456
25823,DKI JAKARTA,26065,JAKARTA TIMUR,26073,PULOGADUNG,74138,81732,155870
25823,DKI JAKARTA,25886,JAKARTA UTARA,25908,CILINCING,93382,93794,187176
25823,DKI JAKARTA,25886,JAKARTA UTARA,25920,KELAPA GADING,22434,54308,76742
25823,DKI JAKARTA,25886,JAKARTA UTARA,25901,KOJA,76160,79492,155652
25823,DKI JAKARTA,25886,JAKARTA UTARA,25916,PADEMANGAN,25556,56042,81598
25823,DKI JAKARTA,25886,JAKARTA UTARA,25887,PENJARINGAN,43759,114244,158003
25823,DKI JAKARTA,25886,JAKARTA UTARA,25893,TANJUNG PRIOK,81605,119515,201120
25823,DKI JAKARTA,25824,KEPULAUAN SERIBU,25829,KEPULAUAN SERIBU SELATAN,2222,3112,5334
25823,DKI JAKARTA,25824,KEPULAUAN SERIBU,25825,KEPULAUAN SERIBU UTARA,4684,4977,9661
74716,GORONTALO,74941,BOALEMO,75012,BOTUMOITO,4685,3330,8015
74716,GORONTALO,74941,BOALEMO,74980,DULUPI,4729,3831,8560
74716,GORONTALO,74941,BOALEMO,75002,MANANGGU,3588,3009,6597
74716,GORONTALO,74941,BOALEMO,74942,PAGUYAMAN,10782,6992,17774
74716,GORONTALO,74941,BOALEMO,75022,PAGUYAMAN PANTAI,2423,2005,4428
74716,GORONTALO,74941,BOALEMO,74989,TILAMUTA,8771,6857,15628
74716,GORONTALO,74941,BOALEMO,74965,WONOSARI,8151,7155,15306
74716,GORONTALO,75031,BONE BOLANGO,75123,BONE,3266,1763,5029
74716,GORONTALO,75031,BONE BOLANGO,75114,BONE RAYA,2360,1251,3611
74716,GORONTALO,75031,BONE BOLANGO,75062,BONEPANTAI,3727,1823,5550
74716,GORONTALO,75031,BONE BOLANGO,75097,BOTUPINGGE,2444,1136,3580
74716,GORONTALO,75031,BONE BOLANGO,75161,BULANGO SELATAN,3866,2137,6003
74716,GORONTALO,75031,BONE BOLANGO,75170,BULANGO TIMUR,2222,977,3199
74716,GORONTALO,75031,BONE BOLANGO,75154,BULANGO ULU,1510,592,2102
74716,GORONTALO,75031,BONE BOLANGO,75075,BULANGO UTARA,2877,1386,4263
74716,GORONTALO,75031,BONE BOLANGO,75176,BULAWA,2047,685,2732
74716,GORONTALO,75031,BONE BOLANGO,75040,KABILA,7763,4896,12659
74716,GORONTALO,75031,BONE BOLANGO,75104,KABILA BONE,3510,2244,5754
74716,GORONTALO,75031,BONE BOLANGO,83776,PINOGU,685,397,1082
74716,GORONTALO,75031,BONE BOLANGO,75053,SUWAWA,4027,2585,6612
74716,GORONTALO,75031,BONE BOLANGO,75141,SUWAWA SELATAN,1479,1349,2828
74716,GORONTALO,75031,BONE BOLANGO,75148,SUWAWA TENGAH,2045,1332,3377
74716,GORONTALO,75031,BONE BOLANGO,75134,SUWAWA TIMUR,1662,1279,2941
74716,GORONTALO,75031,BONE BOLANGO,75032,TAPA,3039,1168,4207
74716,GORONTALO,75031,BONE BOLANGO,75085,TILONGKABILA,6466,3674,10140
74716,GORONTALO,74717,GORONTALO,74913,ASPARAGA,4625,2337,6962
74716,GORONTALO,74717,GORONTALO,74743,BATUDAA,5747,2107,7854
74716,GORONTALO,74717,GORONTALO,74769,BATUDAA PANTAI,4207,1771,5978
74716,GORONTALO,74717,GORONTALO,74930,BILATO,3187,2006,5193
74716,GORONTALO,74717,GORONTALO,74904,BILUHU,2848,1735,4583
74716,GORONTALO,74717,GORONTALO,74779,BOLIYOHUTO,5201,4600,9801
74716,GORONTALO,74717,GORONTALO,74809,BONGOMEME,7864,2855,10719
74716,GORONTALO,74717,GORONTALO,83777,DUNGALIYO,6484,2888,9372
74716,GORONTALO,74717,GORONTALO,74718,LIMBOTO,18154,7695,25849
74716,GORONTALO,74717,GORONTALO,74874,LIMBOTO BARAT,10107,3890,13997
74716,GORONTALO,74717,GORONTALO,74851,MOOTILANGO,6837,3359,10196
74716,GORONTALO,74717,GORONTALO,74862,PULUBALA,9765,3247,13012
74716,GORONTALO,74717,GORONTALO,74894,TABONGO,7036,2526,9562
74716,GORONTALO,74717,GORONTALO,74924,TALAGA JAYA,3584,2442,6026
74716,GORONTALO,74717,GORONTALO,74733,TELAGA,7012,4863,11875
74716,GORONTALO,74717,GORONTALO,74793,TELAGA BIRU,9991,5176,15167
74716,GORONTALO,74717,GORONTALO,74752,TIBAWA,14506,6567,21073
74716,GORONTALO,74717,GORONTALO,74885,TILANGO,5072,2470,7542
74716,GORONTALO,74717,GORONTALO,74835,TOLANGOHULA,7907,4655,12562
74716,GORONTALO,75301,GORONTALO UTARA,75330,ANGGREK,5536,2475,8011
74716,GORONTALO,75301,GORONTALO UTARA,75302,ATINGGOLA,3974,2150,6124
74716,GORONTALO,75301,GORONTALO UTARA,83774,BIAU,1488,1291,2779
74716,GORONTALO,75301,GORONTALO UTARA,83770,GENTUMA RAYA,3223,1648,4871
74716,GORONTALO,75301,GORONTALO UTARA,75315,KWANDANG,9413,4548,13961
74716,GORONTALO,75301,GORONTALO UTARA,83773,MONANO,2260,1335,3595
74716,GORONTALO,75301,GORONTALO UTARA,83772,PONELO KEPULAUAN,1711,393,2104
74716,GORONTALO,75301,GORONTALO UTARA,75341,SUMALATA,3578,2145,5723
74716,GORONTALO,75301,GORONTALO UTARA,83775,SUMALATA TIMUR,2361,1391,3752
74716,GORONTALO,75301,GORONTALO UTARA,75352,TOLINGGULA,3435,1484,4919
74716,GORONTALO,75301,GORONTALO UTARA,83771,TOMOLITO,3290,1301,4591
74716,GORONTALO,75365,KOTA GORONTALO,75413,DUMBO RAYA,5948,3991,9939
74716,GORONTALO,75365,KOTA GORONTALO,75387,DUNGINGI,6624,5148,11772
74716,GORONTALO,75365,KOTA GORONTALO,75419,HULONTHALANGI,5707,3461,9168
74716,GORONTALO,75365,KOTA GORONTALO,75366,KOTA BARAT,7928,3996,11924
74716,GORONTALO,75365,KOTA GORONTALO,75374,KOTA SELATAN,6363,4487,10850
74716,GORONTALO,75365,KOTA GORONTALO,75400,KOTA TENGAH,8447,5045,13492
74716,GORONTALO,75365,KOTA GORONTALO,75393,KOTA TIMUR,9066,4758,13824
74716,GORONTALO,75365,KOTA GORONTALO,75380,KOTA UTARA,6437,3536,9973
74716,GORONTALO,75365,KOTA GORONTALO,75407,SIPATANA,5745,3746,9491
74716,GORONTALO,75183,PAHUWATO,75260,BUNTULIA,2705,3056,5761
74716,GORONTALO,75183,PAHUWATO,75254,DENGILO,1928,1176,3104
74716,GORONTALO,75183,PAHUWATO,75268,DUHIADAA,3139,2648,5787
74716,GORONTALO,75183,PAHUWATO,75195,LEMITO,3154,2089,5243
74716,GORONTALO,75183,PAHUWATO,75218,MARISA,4492,4063,8555
74716,GORONTALO,75183,PAHUWATO,75227,PAGUAT,5011,3582,8593
74716,GORONTALO,75183,PAHUWATO,75239,PATILANGGIO,3043,1744,4787
74716,GORONTALO,75183,PAHUWATO,75184,POPAYATO,3062,2237,5299
74716,GORONTALO,75183,PAHUWATO,75293,POPAYATO BARAT,1448,1895,3343
74716,GORONTALO,75183,PAHUWATO,75285,POPAYATO TIMUR,2253,2060,4313
74716,GORONTALO,75183,PAHUWATO,75204,RANDANGAN,4290,4193,8483
74716,GORONTALO,75183,PAHUWATO,75246,TALUDITI,2192,2057,4249
74716,GORONTALO,75183,PAHUWATO,75277,WANGGARASI,1226,1326,2552
15885,JAMBI,16576,BATANGHARI,16681,BAJUBANG,6693,12232,18925
15885,JAMBI,16576,BATANGHARI,16629,BATIN XXIV,4564,9778,14342
15885,JAMBI,16576,BATANGHARI,16691,MARO SEBO ILIR,3539,3928,7467
15885,JAMBI,16576,BATANGHARI,16666,MARO SEBO ULU,5077,9527,14604
15885,JAMBI,16576,BATANGHARI,16577,MERSAM,6751,7857,14608
15885,JAMBI,16576,BATANGHARI,16608,MUARA BULIAN,17517,13529,31046
15885,JAMBI,16576,BATANGHARI,16594,MUARA TEMBESI,7589,7721,15310
15885,JAMBI,16576,BATANGHARI,16647,PEMAYUNG,8011,8427,16438
15885,JAMBI,17051,BUNGO,17189,BATHIN II PELAYANG,888,3187,4075
15885,JAMBI,17051,BUNGO,17159,BATHIN III,6653,4369,11022
15885,JAMBI,17051,BUNGO,17179,BATHIN III ULU,1919,2437,4356
15885,JAMBI,17051,BUNGO,17153,BATIN II BABEKO,2382,3401,5783
15885,JAMBI,17051,BUNGO,17168,BUNGO DANI,8162,4587,12749
15885,JAMBI,17051,BUNGO,17077,JUJUHAN,4596,4038,8634
15885,JAMBI,17051,BUNGO,17207,JUJUHAN ILIR,2762,3306,6068
15885,JAMBI,17051,BUNGO,17111,LIMBUR LUBUK MENGKUANG,8303,1842,10145
15885,JAMBI,17051,BUNGO,17071,PASAR MUARO BUNGO,7609,3796,11405
15885,JAMBI,17051,BUNGO,17097,PELEPAT,6234,10849,17083
15885,JAMBI,17051,BUNGO,17135,PELEPAT ILIR,11089,15057,26146
15885,JAMBI,17051,BUNGO,17064,RANTAU PANDAN,2998,2670,5668
15885,JAMBI,17051,BUNGO,17174,RIMBO TENGAH,7962,4803,12765
15885,JAMBI,17051,BUNGO,17086,TANAH SEPENGGAL,5289,7291,12580
15885,JAMBI,17051,BUNGO,17195,TANAH SEPENGGAL LINTAS,5988,7546,13534
15885,JAMBI,17051,BUNGO,17052,TANAH TUMBUH,3162,5439,8601
15885,JAMBI,15961,KERINCI,16010,AIR HANGAT,7685,1189,8874
15885,JAMBI,15961,KERINCI,83484,AIR HANGAT BARAT,5517,1260,6777
15885,JAMBI,15961,KERINCI,16111,AIR HANGAT TIMUR,9624,1622,11246
15885,JAMBI,15961,KERINCI,16045,BATANG MERANGIN,2744,1946,4690
15885,JAMBI,15961,KERINCI,83423,BUKITKERMAN,5591,1449,7040
15885,JAMBI,15961,KERINCI,15979,DANAU KERINCI,6905,1588,8493
15885,JAMBI,15961,KERINCI,16168,DEPATI TUJUH,9411,1087,10498
15885,JAMBI,15961,KERINCI,16033,GUNUNG KERINCI,5439,1921,7360
15885,JAMBI,15961,KERINCI,15962,GUNUNG RAYA,3254,1511,4765
15885,JAMBI,15961,KERINCI,16128,GUNUNG TUJUH,4804,2826,7630
15885,JAMBI,15961,KERINCI,16081,KAYU ARO,6688,5817,12505
15885,JAMBI,15961,KERINCI,83870,KAYU ARO BARAT,7380,5302,12682
15885,JAMBI,15961,KERINCI,16060,KELILING DANAU,11353,2450,13803
15885,JAMBI,15961,KERINCI,15994,SITINJAU LAUT,7094,1363,8457
15885,JAMBI,15961,KERINCI,16140,SIULAK,9457,3211,12668
15885,JAMBI,15961,KERINCI,83869,SIULAK MUKAI,1703,4138,5841
15885,JAMBI,17333,KOTA JAMBI,17379,DANAU TELUK,4582,2183,6765
15885,JAMBI,17333,KOTA JAMBI,17346,JAMBI SELATAN,33531,35684,69215
15885,JAMBI,17333,KOTA JAMBI,17356,JAMBI TIMUR,19590,24911,44501
15885,JAMBI,17333,KOTA JAMBI,17396,JELUTUNG,16369,16868,33237
15885,JAMBI,17333,KOTA JAMBI,17385,KOTA BARU,43981,37230,81211
15885,JAMBI,17333,KOTA JAMBI,17367,PASAR JAMBI,3149,3502,6651
15885,JAMBI,17333,KOTA JAMBI,17372,PELAYANGAN,4581,2503,7084
15885,JAMBI,17333,KOTA JAMBI,17334,TELANAIPURA,29777,20088,49865
15885,JAMBI,15886,KOTA SUNGAI PENUH,15923,HAMPARAN RAWANG,7057,1294,8351
15885,JAMBI,15886,KOTA SUNGAI PENUH,83487,KOTO BARU,3139,694,3833
15885,JAMBI,15886,KOTA SUNGAI PENUH,15951,KUMUN DEBAI,3362,1858,5220
15885,JAMBI,15886,KOTA SUNGAI PENUH,15907,PESISIR BUKIT,5100,1055,6155
15885,JAMBI,15886,KOTA SUNGAI PENUH,83486,PONDOK TINGGI,6970,1819,8789
15885,JAMBI,15886,KOTA SUNGAI PENUH,83488,SUNGAIBUNGKAL,3837,1278,5115
15885,JAMBI,15886,KOTA SUNGAI PENUH,15887,SUNGAIPENUH,3731,1303,5034
15885,JAMBI,15886,KOTA SUNGAI PENUH,15937,TANAH KAMPUNG,3185,1254,4439
15885,JAMBI,16183,MERANGIN,16196,BANGKO,15527,9014,24541
15885,JAMBI,16183,MERANGIN,16292,BANGKO  BARAT,2571,3643,6214
15885,JAMBI,16183,MERANGIN,16307,BATANG MASUMAI,3954,1444,5398
15885,JAMBI,16183,MERANGIN,16184,JANGKAT,3823,2325,6148
15885,JAMBI,16183,MERANGIN,16276,LEMBAH MASURAI,4810,6224,11034
15885,JAMBI,16183,MERANGIN,16385,MARGO TABIR,3521,3851,7372
15885,JAMBI,16183,MERANGIN,16205,MUARA SIAU,2103,2841,4944
15885,JAMBI,16183,MERANGIN,16299,NALO TATAN,3176,3784,6960
15885,JAMBI,16183,MERANGIN,16246,PAMENANG,7719,10204,17923
15885,JAMBI,16183,MERANGIN,16318,PAMENANG BARAT,3843,5362,9205
15885,JAMBI,16183,MERANGIN,16380,PAMENANG SELATAN,2785,2787,5572
15885,JAMBI,16183,MERANGIN,16353,PANGKALAN JAMBU,2766,1141,3907
15885,JAMBI,16183,MERANGIN,16375,RENAH PAMENANG,3617,4819,8436
15885,JAMBI,16183,MERANGIN,16340,RENAH PEMBARAP,4952,2115,7067
15885,JAMBI,16183,MERANGIN,16223,SUNGAI MANAU,4176,1322,5498
15885,JAMBI,16183,MERANGIN,16362,SUNGAI TENANG,3572,1763,5335
15885,JAMBI,16183,MERANGIN,16234,TABIR,7757,7323,15080
15885,JAMBI,16183,MERANGIN,16398,TABIR BARAT,3337,2746,6083
15885,JAMBI,16183,MERANGIN,16327,TABIR ILIR,1901,3670,5571
15885,JAMBI,16183,MERANGIN,16392,TABIR LINTAS,1732,2476,4208
15885,JAMBI,16183,MERANGIN,16268,TABIR SELATAN,6435,9787,16222
15885,JAMBI,16183,MERANGIN,16335,TABIR TIMUR,1467,3009,4476
15885,JAMBI,16183,MERANGIN,16261,TABIR ULU,1889,2501,4390
15885,JAMBI,16183,MERANGIN,16413,TIANG PUMPUNG,1540,1256,2796
15885,JAMBI,16699,MUARO JAMBI,16840,BAHAR SELATAN,3414,5524,8938
15885,JAMBI,16699,MUARO JAMBI,83485,BAHAR UTARA,2705,4563,7268
15885,JAMBI,16699,MUARO JAMBI,16700,JAMBI LUAR KOTA,17456,15204,32660
15885,JAMBI,16699,MUARO JAMBI,16736,KUMPEH,5559,6227,11786
15885,JAMBI,16699,MUARO JAMBI,16783,KUMPEH ULU,11373,14702,26075
15885,JAMBI,16699,MUARO JAMBI,16754,MARO SEBO,5282,5638,10920
15885,JAMBI,16699,MUARO JAMBI,16767,MESTONG,7528,13695,21223
15885,JAMBI,16699,MUARO JAMBI,16719,SEKERNAN,8551,13151,21702
15885,JAMBI,16699,MUARO JAMBI,16801,SUNGAI BAHAR,5289,8710,13999
15885,JAMBI,16699,MUARO JAMBI,16813,SUNGAI GELAM,10668,23702,34370
15885,JAMBI,16699,MUARO JAMBI,16851,TAMAN RAJO,3570,3016,6586
15885,JAMBI,16420,SAROLANGUN,16528,AIR HITAM,4078,8358,12436
15885,JAMBI,16420,SAROLANGUN,16421,BATANG ASAI,4821,3849,8670
15885,JAMBI,16420,SAROLANGUN,16539,BATHIN VIII,7002,4897,11899
15885,JAMBI,16420,SAROLANGUN,16567,CERMIN NAN GEDANG,3543,2448,5991
15885,JAMBI,16420,SAROLANGUN,16444,LIMUN,5585,4783,10368
15885,JAMBI,16420,SAROLANGUN,16507,MANDIANGIN,5970,12813,18783
15885,JAMBI,16420,SAROLANGUN,16476,PAUH,3769,8414,12183
15885,JAMBI,16420,SAROLANGUN,16492,PELAWAN,7793,8655,16448
15885,JAMBI,16420,SAROLANGUN,16460,SAROLANGUN,17727,9566,27293
15885,JAMBI,16420,SAROLANGUN,16556,SINGKUT,8310,12660,20970
15885,JAMBI,16862,TANJUNG JABUNG BARAT,16903,BATANG ASAM,4154,9031,13185
15885,JAMBI,16862,TANJUNG JABUNG BARAT,16883,BETARA,4117,7705,11822
15885,JAMBI,16862,TANJUNG JABUNG BARAT,16928,BRAM ITAM,3788,4532,8320
15885,JAMBI,16862,TANJUNG JABUNG BARAT,16933,KUALA BETARA,3531,3124,6655
15885,JAMBI,16862,TANJUNG JABUNG BARAT,16888,MERLUNG,3325,4559,7884
15885,JAMBI,16862,TANJUNG JABUNG BARAT,16917,MUARA PAPALIK,2234,3363,5597
15885,JAMBI,16862,TANJUNG JABUNG BARAT,16878,PENGABUAN,5332,7031,12363
15885,JAMBI,16862,TANJUNG JABUNG BARAT,16910,RENAH MENDALUH,2281,3957,6238
15885,JAMBI,16862,TANJUNG JABUNG BARAT,16923,SEBERANG KOTA,1896,2316,4212
15885,JAMBI,16862,TANJUNG JABUNG BARAT,16938,SENYERANG,5288,6593,11881
15885,JAMBI,16862,TANJUNG JABUNG BARAT,16897,TEBING TINGGI,8607,6973,15580
15885,JAMBI,16862,TANJUNG JABUNG BARAT,16871,TUNGKAL ILIR,16516,15705,32221
15885,JAMBI,16862,TANJUNG JABUNG BARAT,16863,TUNGKAL ULU,2737,4201,6938
15885,JAMBI,16946,TANJUNG JABUNG TIMUR,17044,BERBAK,2056,2864,4920
15885,JAMBI,16946,TANJUNG JABUNG TIMUR,17003,DENDANG,3014,6001,9015
15885,JAMBI,16946,TANJUNG JABUNG TIMUR,17034,GERAGAI,4448,8985,13433
15885,JAMBI,16946,TANJUNG JABUNG TIMUR,17019,KUALA JAMBI,3044,4451,7495
15885,JAMBI,16946,TANJUNG JABUNG TIMUR,16971,MENDAHARA,5514,8133,13647
15885,JAMBI,16946,TANJUNG JABUNG TIMUR,17026,MENDAHARA ULU,2975,5247,8222
15885,JAMBI,16946,TANJUNG JABUNG TIMUR,17011,MUARA SABAK BARAT,3610,5136,8746
15885,JAMBI,16946,TANJUNG JABUNG TIMUR,16947,MUARA SABAK TIMUR,5789,11453,17242
15885,JAMBI,16946,TANJUNG JABUNG TIMUR,16960,NIPAH PANJANG,5961,7281,13242
15885,JAMBI,16946,TANJUNG JABUNG TIMUR,16981,RANTAU RASAU,4989,7801,12790
15885,JAMBI,16946,TANJUNG JABUNG TIMUR,16993,S A D U,3519,4079,7598
15885,JAMBI,17215,TEBO,17325,MUARA TABIR,2795,5570,8365
15885,JAMBI,17215,TEBO,17254,RIMBO BUJANG,14800,20051,34851
15885,JAMBI,17215,TEBO,17294,RIMBO ILIR,5815,8805,14620
15885,JAMBI,17215,TEBO,17287,RIMBO ULU,7310,14933,22243
15885,JAMBI,17215,TEBO,17310,SERAI SERUMPUN,1502,3127,4629
15885,JAMBI,17215,TEBO,17263,SUMAY,2946,7022,9968
15885,JAMBI,17215,TEBO,17229,TEBO ILIR,6215,8066,14281
15885,JAMBI,17215,TEBO,17216,TEBO TENGAH,9219,9931,19150
15885,JAMBI,17215,TEBO,17241,TEBO ULU,6341,9787,16128
15885,JAMBI,17215,TEBO,17304,TENGAH ILIR,3432,9269,12701
15885,JAMBI,17215,TEBO,17276,VII KOTO,3587,6576,10163
15885,JAMBI,17215,TEBO,17319,VII KOTO ILIR,2210,5414,7624
26141,JAWA BARAT,27407,BANDUNG,27500,ARJASARI,34134,16384,50518
26141,JAWA BARAT,27407,BANDUNG,27603,BALEENDAH,82926,41624,124550
26141,JAWA BARAT,27407,BANDUNG,27467,BANJARAN,44649,22642,67291
26141,JAWA BARAT,27407,BANDUNG,27432,BOJONGSOANG,38930,17308,56238
26141,JAWA BARAT,27407,BANDUNG,27694,CANGKUANG,23589,16224,39813
26141,JAWA BARAT,27407,BANDUNG,27522,CICALENGKA,44238,16492,60730
26141,JAWA BARAT,27407,BANDUNG,27542,CIKANCUNG,28918,14776,43694
26141,JAWA BARAT,27407,BANDUNG,27425,CILENGKRANG,17007,9743,26750
26141,JAWA BARAT,27407,BANDUNG,27408,CILEUNYI,59862,27140,87002
26141,JAWA BARAT,27407,BANDUNG,27512,CIMAUNG,24421,19288,43709
26141,JAWA BARAT,27407,BANDUNG,27415,CIMENYAN,33979,26828,60807
26141,JAWA BARAT,27407,BANDUNG,27566,CIPARAY,62511,24786,87297
26141,JAWA BARAT,27407,BANDUNG,27680,CIWIDEY,25975,18848,44823
26141,JAWA BARAT,27407,BANDUNG,27460,DAYEUHKOLOT,37072,21079,58151
26141,JAWA BARAT,27407,BANDUNG,27645,IBUN,22914,22882,45796
26141,JAWA BARAT,27407,BANDUNG,27452,KATAPANG,35809,25306,61115
26141,JAWA BARAT,27407,BANDUNG,27595,KERTASARI,30452,9076,39528
26141,JAWA BARAT,27407,BANDUNG,27702,KUTAWARINGIN,34797,18895,53692
26141,JAWA BARAT,27407,BANDUNG,27612,MAJALAYA,53547,34445,87992
26141,JAWA BARAT,27407,BANDUNG,27445,MARGAASIH,42175,32381,74556
26141,JAWA BARAT,27407,BANDUNG,27439,MARGAHAYU,35764,28405,64169
26141,JAWA BARAT,27407,BANDUNG,27535,NAGREG,17994,9503,27497
26141,JAWA BARAT,27407,BANDUNG,27581,PACET,35103,18341,53444
26141,JAWA BARAT,27407,BANDUNG,27479,PAMEUNGPEUK,30339,11092,41431
26141,JAWA BARAT,27407,BANDUNG,27486,PANGALENGAN,56347,25684,82031
26141,JAWA BARAT,27407,BANDUNG,27632,PASEH,35816,31428,67244
26141,JAWA BARAT,27407,BANDUNG,27669,PASIRJAMBU,27468,19645,47113
26141,JAWA BARAT,27407,BANDUNG,27688,RANCABALI,16601,11857,28458
26141,JAWA BARAT,27407,BANDUNG,27552,RANCAEKEK,69199,22799,91998
26141,JAWA BARAT,27407,BANDUNG,27624,SOLOKANJERUK,28651,18712,47363
26141,JAWA BARAT,27407,BANDUNG,27658,SOREANG,39922,21431,61353
26141,JAWA BARAT,31896,BANDUNG BARAT,31994,BATUJAJAR,37174,14817,51991
26141,JAWA BARAT,31896,BANDUNG BARAT,32008,CIHAMPELAS,38947,20765,59712
26141,JAWA BARAT,31896,BANDUNG BARAT,31931,CIKALONGWETAN,38236,25677,63913
26141,JAWA BARAT,31896,BANDUNG BARAT,32019,CILILIN,29662,16597,46259
26141,JAWA BARAT,31896,BANDUNG BARAT,31970,CIPATAT,39499,28711,68210
26141,JAWA BARAT,31896,BANDUNG BARAT,31945,CIPEUNDEUY,27189,14595,41784
26141,JAWA BARAT,31896,BANDUNG BARAT,32031,CIPONGKOR,27612,13537,41149
26141,JAWA BARAT,31896,BANDUNG BARAT,31922,CISARUA,22605,19403,42008
26141,JAWA BARAT,31896,BANDUNG BARAT,32067,GUNUNGHALU,24211,12846,37057
26141,JAWA BARAT,31896,BANDUNG BARAT,31897,LEMBANG,61223,46661,107884
26141,JAWA BARAT,31896,BANDUNG BARAT,31958,NGAMPRAH,57936,32105,90041
26141,JAWA BARAT,31896,BANDUNG BARAT,31983,PADALARANG,64064,29378,93442
26141,JAWA BARAT,31896,BANDUNG BARAT,31914,PARONGPONG,30776,28530,59306
26141,JAWA BARAT,31896,BANDUNG BARAT,32046,RONGGA,17851,9433,27284
26141,JAWA BARAT,31896,BANDUNG BARAT,83521,SAGULING,9229,6993,16222
26141,JAWA BARAT,31896,BANDUNG BARAT,32055,SINDANGKERTA,21517,12037,33554
26141,JAWA BARAT,31685,BEKASI,31695,BABELAN,0,0,0
26141,JAWA BARAT,31685,BEKASI,31889,BOJONGMANGU,0,0,0
26141,JAWA BARAT,31685,BEKASI,31829,CABANGBUNGIN,0,0,0
26141,JAWA BARAT,31685,BEKASI,31881,CIBARUSAH,0,0,0
26141,JAWA BARAT,31685,BEKASI,31741,CIBITUNG,0,0,0
26141,JAWA BARAT,31685,BEKASI,31749,CIKARANG BARAT,0,0,0
26141,JAWA BARAT,31685,BEKASI,31865,CIKARANG PUSAT,0,0,0
26141,JAWA BARAT,31685,BEKASI,31857,CIKARANG SELATAN,0,0,0
26141,JAWA BARAT,31685,BEKASI,31782,CIKARANG TIMUR,0,0,0
26141,JAWA BARAT,31685,BEKASI,31761,CIKARANG UTARA,0,0,0
26141,JAWA BARAT,31685,BEKASI,31773,KARANG BAHAGIA,0,0,0
26141,JAWA BARAT,31685,BEKASI,31791,KEDUNG WARINGIN,0,0,0
26141,JAWA BARAT,31685,BEKASI,31838,MUARAGEMBONG,0,0,0
26141,JAWA BARAT,31685,BEKASI,31799,PEBAYURAN,0,0,0
26141,JAWA BARAT,31685,BEKASI,31872,SERANG BARU,0,0,0
26141,JAWA BARAT,31685,BEKASI,31845,SETU,0,0,0
26141,JAWA BARAT,31685,BEKASI,31813,SUKAKARYA,0,0,0
26141,JAWA BARAT,31685,BEKASI,31821,SUKATANI,0,0,0
26141,JAWA BARAT,31685,BEKASI,31705,SUKAWANGI,0,0,0
26141,JAWA BARAT,31685,BEKASI,31713,TAMBELANG,0,0,0
26141,JAWA BARAT,31685,BEKASI,31730,TAMBUN SELATAN,0,0,0
26141,JAWA BARAT,31685,BEKASI,31721,TAMBUN UTARA,0,0,0
26141,JAWA BARAT,31685,BEKASI,31686,TARUMAJAYA,0,0,0
26141,JAWA BARAT,26142,BOGOR,26196,BABAKAN MADANG,39316,12789,52105
26141,JAWA BARAT,26142,BOGOR,26287,BOJONG GEDE,72754,48959,121713
26141,JAWA BARAT,26142,BOGOR,26472,CARINGIN,43721,15682,59403
26141,JAWA BARAT,26142,BOGOR,26234,CARIU,23549,6800,30349
26141,JAWA BARAT,26142,BOGOR,26309,CIAMPEA,47438,32069,79507
26141,JAWA BARAT,26142,BOGOR,26435,CIAWI,38803,15353,54156
26141,JAWA BARAT,26142,BOGOR,26143,CIBINONG,107445,58743,166188
26141,JAWA BARAT,26142,BOGOR,26323,CIBUNGBULANG,43046,24243,67289
26141,JAWA BARAT,26142,BOGOR,26585,CIGOMBONG,31090,13430,44520
26141,JAWA BARAT,26142,BOGOR,26409,CIGUDEG,33298,21573,54871
26141,JAWA BARAT,26142,BOGOR,26485,CIJERUK,25985,11818,37803
26141,JAWA BARAT,26142,BOGOR,26221,CILEUNGSI,83013,39646,122659
26141,JAWA BARAT,26142,BOGOR,26495,CIOMAS,53243,27936,81179
26141,JAWA BARAT,26142,BOGOR,26449,CISARUA,44885,17662,62547
26141,JAWA BARAT,26142,BOGOR,26537,CISEENG,31951,21509,53460
26141,JAWA BARAT,26142,BOGOR,26167,CITEUREUP,70371,28569,98940
26141,JAWA BARAT,26142,BOGOR,26507,DRAMAGA,33786,23243,57029
26141,JAWA BARAT,26142,BOGOR,26156,GUNUNG PUTRI,96077,45519,141596
26141,JAWA BARAT,26142,BOGOR,26266,GUNUNG SINDUR,30396,24732,55128
26141,JAWA BARAT,26142,BOGOR,26369,JASINGA,28354,16557,44911
26141,JAWA BARAT,26142,BOGOR,26206,JONGGOL,54417,16908,71325
26141,JAWA BARAT,26142,BOGOR,26277,KEMANG,29337,21546,50883
26141,JAWA BARAT,26142,BOGOR,26527,KLAPANUNGGAL,43103,11655,54758
26141,JAWA BARAT,26142,BOGOR,26297,LEUWILIANG,40257,17777,58034
26141,JAWA BARAT,26142,BOGOR,26595,LEUWISADENG,24764,9906,34670
26141,JAWA BARAT,26142,BOGOR,26460,MEGAMENDUNG,36197,15185,51382
26141,JAWA BARAT,26142,BOGOR,26398,NANGGUNG,27599,16992,44591
26141,JAWA BARAT,26142,BOGOR,26339,PAMIJAHAN,44937,22589,67526
26141,JAWA BARAT,26142,BOGOR,26256,PARUNG,38083,24181,62264
26141,JAWA BARAT,26142,BOGOR,26386,PARUNG PANJANG,29093,26034,55127
26141,JAWA BARAT,26142,BOGOR,26548,RANCA BUNGUR,17186,11940,29126
26141,JAWA BARAT,26142,BOGOR,26355,RUMPIN,37497,26711,64208
26141,JAWA BARAT,26142,BOGOR,26556,SUKAJAYA,23045,11893,34938
26141,JAWA BARAT,26142,BOGOR,26245,SUKAMAKMUR,28131,10448,38579
26141,JAWA BARAT,26142,BOGOR,26182,SUKARAJA,61972,28474,90446
26141,JAWA BARAT,26142,BOGOR,26577,TAJURHALANG,31562,21230,52792
26141,JAWA BARAT,26142,BOGOR,26518,TAMANSARI,31331,20948,52279
26141,JAWA BARAT,26142,BOGOR,26566,TANJUNGSARI,22245,7669,29914
26141,JAWA BARAT,26142,BOGOR,26425,TENJO,18445,12889,31334
26141,JAWA BARAT,26142,BOGOR,26604,TENJOLAYA,18412,11081,29493
26141,JAWA BARAT,28573,CIAMIS,28760,BANJARSARI,29787,29626,59413
26141,JAWA BARAT,28573,CIAMIS,28919,BAREGBEG,14128,10411,24539
26141,JAWA BARAT,28573,CIAMIS,28574,CIAMIS,37756,19860,57616
26141,JAWA BARAT,28573,CIAMIS,28618,CIDOLOG,6259,4978,11237
26141,JAWA BARAT,28573,CIAMIS,28869,CIGUGUR,7632,4469,12101
26141,JAWA BARAT,28573,CIAMIS,28625,CIHAURBEUTI,18575,7821,26396
26141,JAWA BARAT,28573,CIAMIS,28597,CIJEUNGJING,20137,10517,30654
26141,JAWA BARAT,28573,CIAMIS,28849,CIJULANG,9149,8403,17552
26141,JAWA BARAT,28573,CIAMIS,28587,CIKONENG,18785,11320,30105
26141,JAWA BARAT,28573,CIAMIS,28891,CIMARAGAS,4629,4943,9572
26141,JAWA BARAT,28573,CIAMIS,28857,CIMERAK,13281,13636,26917
26141,JAWA BARAT,28573,CIAMIS,28688,CIPAKU,20747,13552,34299
26141,JAWA BARAT,28573,CIAMIS,28897,CISAGA,11348,11562,22910
26141,JAWA BARAT,28573,CIAMIS,28702,JATINAGARA,8632,5310,13942
26141,JAWA BARAT,28573,CIAMIS,28811,KALIPUCANG,9417,11748,21165
26141,JAWA BARAT,28573,CIAMIS,28661,KAWALI,15345,8295,23640
26141,JAWA BARAT,28573,CIAMIS,28749,LAKBOK,10546,17619,28165
26141,JAWA BARAT,28573,CIAMIS,28877,LANGKAPLANCAR,13348,14281,27629
26141,JAWA BARAT,28573,CIAMIS,28935,LUMBUNG,11570,4842,16412
26141,JAWA BARAT,28573,CIAMIS,28954,MANGUNJAYA,7900,9041,16941
26141,JAWA BARAT,28573,CIAMIS,28796,PADAHERANG,15464,20394,35858
26141,JAWA BARAT,28573,CIAMIS,28782,PAMARICAN,17606,20395,38001
26141,JAWA BARAT,28573,CIAMIS,28673,PANAWANGAN,13025,15081,28106
26141,JAWA BARAT,28573,CIAMIS,28821,PANGANDARAN,11991,20180,32171
26141,JAWA BARAT,28573,CIAMIS,28652,PANJALU,15200,7271,22471
26141,JAWA BARAT,28573,CIAMIS,28637,PANUMBANGAN,17570,13589,31159
26141,JAWA BARAT,28573,CIAMIS,28838,PARIGI,11667,16578,28245
26141,JAWA BARAT,28573,CIAMIS,28944,PURWADADI,9277,11038,20315
26141,JAWA BARAT,28573,CIAMIS,28709,RAJADESA,18742,7839,26581
26141,JAWA BARAT,28573,CIAMIS,28728,RANCAH,18807,14138,32945
26141,JAWA BARAT,28573,CIAMIS,28609,SADANANYA,12168,8641,20809
26141,JAWA BARAT,28573,CIAMIS,28830,SIDAMULIH,6563,11076,17639
26141,JAWA BARAT,28573,CIAMIS,28909,SINDANGKASIH,17694,9266,26960
26141,JAWA BARAT,28573,CIAMIS,28721,SUKADANA,7465,6769,14234
26141,JAWA BARAT,28573,CIAMIS,28929,SUKAMANTRI,5969,4905,10874
26141,JAWA BARAT,28573,CIAMIS,28742,TAMBAKSARI,4711,9111,13822
26141,JAWA BARAT,27026,CIANJUR,27298,AGRABINTA,9703,9297,19000
26141,JAWA BARAT,27026,CIANJUR,27091,BOJONGPICUNG,22425,13512,35937
26141,JAWA BARAT,27026,CIANJUR,27211,CAMPAKA,19389,11422,30811
26141,JAWA BARAT,27026,CIANJUR,27334,CAMPAKAMULYA,7441,4714,12155
26141,JAWA BARAT,27026,CIANJUR,27027,CIANJUR,53353,32961,86314
26141,JAWA BARAT,27026,CIANJUR,27051,CIBEBER,38806,19237,58043
26141,JAWA BARAT,27026,CIANJUR,27274,CIBINONG,15048,15197,30245
26141,JAWA BARAT,27026,CIANJUR,27309,CIDAUN,13558,17069,30627
26141,JAWA BARAT,27026,CIANJUR,27367,CIJATI,8011,7515,15526
26141,JAWA BARAT,27026,CIANJUR,27340,CIKADU,7121,9959,17080
26141,JAWA BARAT,27026,CIANJUR,27169,CIKALONGKULON,28477,16459,44936
26141,JAWA BARAT,27026,CIANJUR,27070,CILAKU,30811,17588,48399
26141,JAWA BARAT,27026,CIANJUR,27359,CIPANAS,30883,20033,50916
26141,JAWA BARAT,27026,CIANJUR,27081,CIRANJANG,22548,16298,38846
26141,JAWA BARAT,27026,CIANJUR,27152,CUGENANG,27871,20606,48477
26141,JAWA BARAT,27026,CIANJUR,27350,GEKBRONG,13597,9585,23182
26141,JAWA BARAT,27026,CIANJUR,27389,HAURWANGI,16611,11790,28401
26141,JAWA BARAT,27026,CIANJUR,27233,KADUPANDAK,11380,11873,23253
26141,JAWA BARAT,27026,CIANJUR,27103,KARANGTENGAH,46088,21769,67857
26141,JAWA BARAT,27026,CIANJUR,27377,LELES,11169,6663,17832
26141,JAWA BARAT,27026,CIANJUR,27120,MANDE,20692,13211,33903
26141,JAWA BARAT,27026,CIANJUR,27323,NARINGGUL,9805,12395,22200
26141,JAWA BARAT,27026,CIANJUR,27144,PACET,27971,18529,46500
26141,JAWA BARAT,27026,CIANJUR,27247,PAGELARAN,21456,13752,35208
26141,JAWA BARAT,27026,CIANJUR,27398,PASIRKUDA,10868,7376,18244
26141,JAWA BARAT,27026,CIANJUR,27288,SINDANGBARANG,12606,13112,25718
26141,JAWA BARAT,27026,CIANJUR,27133,SUKALUYU,21137,13150,34287
26141,JAWA BARAT,27026,CIANJUR,27200,SUKANAGARA,14793,10014,24807
26141,JAWA BARAT,27026,CIANJUR,27188,SUKARESMI,23812,14344,38156
26141,JAWA BARAT,27026,CIANJUR,27223,TAKOKAK,11551,13525,25076
26141,JAWA BARAT,27026,CIANJUR,27261,TANGGEUNG,13459,8823,22282
26141,JAWA BARAT,27026,CIANJUR,27039,WARUNGKONDANG,21282,11044,32326
26141,JAWA BARAT,29369,CIREBON,29653,ARJAWINANGUN,14579,19608,34187
26141,JAWA BARAT,29369,CIREBON,29482,ASTANAJAPURA,14839,16940,31779
26141,JAWA BARAT,29369,CIREBON,29419,BABAKAN,9756,23583,33339
26141,JAWA BARAT,29369,CIREBON,29517,BEBER,8210,10023,18233
26141,JAWA BARAT,29369,CIREBON,29383,CILEDUG,10078,13216,23294
26141,JAWA BARAT,29369,CIREBON,29675,CIWARINGIN,7755,11197,18952
26141,JAWA BARAT,29369,CIREBON,29736,DEPOK,11732,20515,32247
26141,JAWA BARAT,29369,CIREBON,29555,DUKUPUNTANG,13604,19718,33322
26141,JAWA BARAT,29369,CIREBON,29722,GEBANG,8678,22672,31350
26141,JAWA BARAT,29369,CIREBON,29697,GEGESIK,15500,18798,34298
26141,JAWA BARAT,29369,CIREBON,29795,GEMPOL,8811,14151,22962
26141,JAWA BARAT,29369,CIREBON,29804,GREGED,8598,11674,20272
26141,JAWA BARAT,29369,CIREBON,29617,GUNUNG JATI,20705,23481,44186
26141,JAWA BARAT,29369,CIREBON,29825,JAMBLANG,5760,13273,19033
26141,JAWA BARAT,29369,CIREBON,29712,KALIWEDI,8168,9979,18147
26141,JAWA BARAT,29369,CIREBON,29633,KAPETAKAN,10745,16487,27232
26141,JAWA BARAT,29369,CIREBON,29434,KARANGSEMBUNG,6493,11353,17846
26141,JAWA BARAT,29369,CIREBON,29765,KARANGWARENG,3734,10083,13817
26141,JAWA BARAT,29369,CIREBON,29608,KEDAWUNG,14586,18019,32605
26141,JAWA BARAT,29369,CIREBON,29643,KLANGENAN,8728,16123,24851
26141,JAWA BARAT,29369,CIREBON,29443,LEMAHABANG,10776,14888,25664
26141,JAWA BARAT,29369,CIREBON,29394,LOSARI,9989,17005,26994
26141,JAWA BARAT,29369,CIREBON,29504,MUNDU,15338,21179,36517
26141,JAWA BARAT,29369,CIREBON,29405,PABEDILAN,8678,19385,28063
26141,JAWA BARAT,29369,CIREBON,29757,PABUARAN,5536,13280,18816
26141,JAWA BARAT,29369,CIREBON,29569,PALIMANAN,12916,18582,31498
26141,JAWA BARAT,29369,CIREBON,29494,PANGENAN,7001,12415,19416
26141,JAWA BARAT,29369,CIREBON,29665,PANGURAGAN,9007,10494,19501
26141,JAWA BARAT,29369,CIREBON,29749,PASALEMAN,4466,7111,11577
26141,JAWA BARAT,29369,CIREBON,29784,PLERED,9317,19213,28530
26141,JAWA BARAT,29369,CIREBON,29582,PLUMBON,15970,26697,42667
26141,JAWA BARAT,29369,CIREBON,29471,SEDONG,5959,11819,17778
26141,JAWA BARAT,29369,CIREBON,29540,SUMBER,17921,25894,43815
26141,JAWA BARAT,29369,CIREBON,29815,SURANENGGALA,9593,14309,23902
26141,JAWA BARAT,29369,CIREBON,29684,SUSUKAN,11369,20285,31654
26141,JAWA BARAT,29369,CIREBON,29457,SUSUKAN LEBAK,5487,12611,18098
26141,JAWA BARAT,29369,CIREBON,29528,TALUN,14149,17092,31241
26141,JAWA BARAT,29369,CIREBON,29775,TENGAH TANI,9005,13933,22938
26141,JAWA BARAT,29369,CIREBON,29370,WALED,7538,15533,23071
26141,JAWA BARAT,29369,CIREBON,29598,WERU,14443,21069,35512
26141,JAWA BARAT,27714,GARUT,28002,BANJARWANGI,18282,7485,25767
26141,JAWA BARAT,27714,GARUT,27784,BANYURESMI,32595,9763,42358
26141,JAWA BARAT,27714,GARUT,27922,BAYONGBONG,32872,13104,45976
26141,JAWA BARAT,27714,GARUT,28077,BUNGBULANG,19611,9770,29381
26141,JAWA BARAT,27714,GARUT,28122,CARINGIN,9271,6273,15544
26141,JAWA BARAT,27714,GARUT,28056,CIBALONG,12961,9929,22890
26141,JAWA BARAT,27714,GARUT,27863,CIBATU,25295,8170,33465
26141,JAWA BARAT,27714,GARUT,28159,CIBIUK,9768,3975,13743
26141,JAWA BARAT,27714,GARUT,27940,CIGEDUG,12059,5757,17816
26141,JAWA BARAT,27714,GARUT,28024,CIHURIP,5364,3368,8732
26141,JAWA BARAT,27714,GARUT,27989,CIKAJANG,29211,11156,40367
26141,JAWA BARAT,27714,GARUT,28067,CIKELET,14860,5883,20743
26141,JAWA BARAT,27714,GARUT,27946,CILAWU,38972,15508,54480
26141,JAWA BARAT,27714,GARUT,28114,CISEWU,13258,6407,19665
26141,JAWA BARAT,27714,GARUT,28044,CISOMPET,15431,10583,26014
26141,JAWA BARAT,27714,GARUT,27965,CISURUPAN,29731,17503,47234
26141,JAWA BARAT,27714,GARUT,27715,GARUT KOTA,46288,24890,71178
26141,JAWA BARAT,27714,GARUT,27839,KADUNGORA,31164,14989,46153
26141,JAWA BARAT,27714,GARUT,27727,KARANGPAWITAN,46147,17689,63836
26141,JAWA BARAT,27714,GARUT,27917,KARANGTENGAH,5092,2056,7148
26141,JAWA BARAT,27714,GARUT,27875,KERSAMANAH,13528,4000,17528
26141,JAWA BARAT,27714,GARUT,27826,LELES,26191,13945,40136
26141,JAWA BARAT,27714,GARUT,27854,LEUWIGOONG,14634,6402,21036
26141,JAWA BARAT,27714,GARUT,27881,MALANGBONG,40140,14810,54950
26141,JAWA BARAT,27714,GARUT,28090,MEKARMUKTI,4901,3469,8370
26141,JAWA BARAT,27714,GARUT,28095,PAKENJENG,22614,9327,31941
26141,JAWA BARAT,27714,GARUT,28036,PAMEUNGPEUK,16415,4952,21367
26141,JAWA BARAT,27714,GARUT,28108,PAMULIHAN,6468,2753,9221
26141,JAWA BARAT,27714,GARUT,28165,PANGATIKAN,13844,3388,17232
26141,JAWA BARAT,27714,GARUT,27813,PASIRWANGI,25155,8343,33498
26141,JAWA BARAT,27714,GARUT,28029,PEUNDEUY,7306,2360,9666
26141,JAWA BARAT,27714,GARUT,27800,SAMARANG,27174,9363,36537
26141,JAWA BARAT,27714,GARUT,28151,SELAAWI,13690,6021,19711
26141,JAWA BARAT,27714,GARUT,28014,SINGAJAYA,14071,6259,20330
26141,JAWA BARAT,27714,GARUT,28174,SUCINARAJA,9707,4407,14114
26141,JAWA BARAT,27714,GARUT,27982,SUKARESMI,13396,4486,17882
26141,JAWA BARAT,27714,GARUT,27905,SUKAWENING,18554,5816,24370
26141,JAWA BARAT,27714,GARUT,28128,TALEGONG,9988,6735,16723
26141,JAWA BARAT,27714,GARUT,27757,TAROGONG KALER,34797,13985,48782
26141,JAWA BARAT,27714,GARUT,27771,TAROGONG KIDUL,43410,15069,58479
26141,JAWA BARAT,27714,GARUT,27748,WANARAJA,16373,6532,22905
26141,JAWA BARAT,30503,INDRAMAYU,30765,ANJATAN,15780,29609,45389
26141,JAWA BARAT,30503,INDRAMAYU,30720,ARAHAN,6235,10834,17069
26141,JAWA BARAT,30503,INDRAMAYU,30658,BALONGAN,10005,11049,21054
26141,JAWA BARAT,30503,INDRAMAYU,30556,BANGODUA,6050,8654,14704
26141,JAWA BARAT,30503,INDRAMAYU,30756,BONGAS,10345,15694,26039
26141,JAWA BARAT,30503,INDRAMAYU,30699,CANTIGI,3563,9434,12997
26141,JAWA BARAT,30503,INDRAMAYU,30536,CIKEDUNG,12042,11563,23605
26141,JAWA BARAT,30503,INDRAMAYU,30525,GABUSWETAN,11602,19176,30778
26141,JAWA BARAT,30503,INDRAMAYU,30788,GANTAR,15996,14124,30120
26141,JAWA BARAT,30503,INDRAMAYU,30504,HAURGEULIS,19672,23661,43333
26141,JAWA BARAT,30503,INDRAMAYU,30669,INDRAMAYU,26417,32843,59260
26141,JAWA BARAT,30503,INDRAMAYU,30642,JATIBARANG,14193,25565,39758
26141,JAWA BARAT,30503,INDRAMAYU,30614,JUNTINYUAT,18674,24118,42792
26141,JAWA BARAT,30503,INDRAMAYU,30742,KANDANGHAUR,16269,27197,43466
26141,JAWA BARAT,30503,INDRAMAYU,30602,KARANGAMPEL,12071,20542,32613
26141,JAWA BARAT,30503,INDRAMAYU,30813,KEDOKAN BUNDER,10162,13842,24004
26141,JAWA BARAT,30503,INDRAMAYU,30576,KERTASEMAYA,11547,17620,29167
26141,JAWA BARAT,30503,INDRAMAYU,30590,KRANGKENG,13640,19495,33135
26141,JAWA BARAT,30503,INDRAMAYU,30515,KROYA,12121,20605,32726
26141,JAWA BARAT,30503,INDRAMAYU,30544,LELEA,11034,15901,26935
26141,JAWA BARAT,30503,INDRAMAYU,30707,LOHBENER,10425,19395,29820
26141,JAWA BARAT,30503,INDRAMAYU,30729,LOSARANG,11448,17000,28448
26141,JAWA BARAT,30503,INDRAMAYU,30821,PASEKAN,4037,8899,12936
26141,JAWA BARAT,30503,INDRAMAYU,30842,PATROL,8916,19410,28326
26141,JAWA BARAT,30503,INDRAMAYU,30688,SINDANG,11934,15742,27676
26141,JAWA BARAT,30503,INDRAMAYU,30627,SLIYEG,12422,22184,34606
26141,JAWA BARAT,30503,INDRAMAYU,30805,SUKAGUMIWANG,9282,8363,17645
26141,JAWA BARAT,30503,INDRAMAYU,30779,SUKRA,8612,15622,24234
26141,JAWA BARAT,30503,INDRAMAYU,30795,TRISI,14216,16730,30946
26141,JAWA BARAT,30503,INDRAMAYU,30828,TUKDANA,14669,13602,28271
26141,JAWA BARAT,30503,INDRAMAYU,30565,WIDASARI,7665,12359,20024
26141,JAWA BARAT,31345,KARAWANG,31612,BANYUSARI,0,0,0
26141,JAWA BARAT,31345,KARAWANG,31419,BATUJAYA,22550,15006,37556
26141,JAWA BARAT,31345,KARAWANG,31374,CIAMPEL,0,0,0
26141,JAWA BARAT,31345,KARAWANG,31455,CIBUAYA,14042,11461,25503
26141,JAWA BARAT,31345,KARAWANG,31476,CIKAMPEK,0,0,0
26141,JAWA BARAT,31345,KARAWANG,31599,CILAMAYA KULON,0,0,0
26141,JAWA BARAT,31345,KARAWANG,31502,CILAMAYA WETAN,0,0,0
26141,JAWA BARAT,31345,KARAWANG,31674,CILEBAR,0,0,0
26141,JAWA BARAT,31345,KARAWANG,31487,JATISARI,0,0,0
26141,JAWA BARAT,31345,KARAWANG,31590,JAYAKERTA,16466,13440,29906
26141,JAWA BARAT,31345,KARAWANG,31346,KARAWANG BARAT,0,0,0
26141,JAWA BARAT,31345,KARAWANG,31635,KARAWANG TIMUR,37638,26956,64594
26141,JAWA BARAT,31345,KARAWANG,31382,KLARI,0,0,0
26141,JAWA BARAT,31345,KARAWANG,31625,KOTA BARU,39077,24144,63221
26141,JAWA BARAT,31345,KARAWANG,31406,KUTAWALUYA,17271,14119,31390
26141,JAWA BARAT,31345,KARAWANG,31555,LEMAHABANG,24144,12579,36723
26141,JAWA BARAT,31345,KARAWANG,31582,MAJALAYA,16638,9427,26065
26141,JAWA BARAT,31345,KARAWANG,31467,PAKISJAYA,0,0,0
26141,JAWA BARAT,31345,KARAWANG,31355,PANGKALAN,0,0,0
26141,JAWA BARAT,31345,KARAWANG,31442,PEDES,17848,19276,37124
26141,JAWA BARAT,31345,KARAWANG,31665,PURWASARI,0,0,0
26141,JAWA BARAT,31345,KARAWANG,31541,RAWAMERTA,18536,11045,29581
26141,JAWA BARAT,31345,KARAWANG,31396,RENGASDENGKLOK,0,0,0
26141,JAWA BARAT,31345,KARAWANG,31655,TEGALWARU,14777,4671,19448
26141,JAWA BARAT,31345,KARAWANG,31526,TELAGASARI,24019,13403,37422
26141,JAWA BARAT,31345,KARAWANG,31644,TELUKJAMBE BARAT,19937,10094,30031
26141,JAWA BARAT,31345,KARAWANG,31364,TELUKJAMBE TIMUR,39307,23257,62564
26141,JAWA BARAT,31345,KARAWANG,31567,TEMPURAN,20067,15617,35684
26141,JAWA BARAT,31345,KARAWANG,31430,TIRTAJAYA,19590,15152,34742
26141,JAWA BARAT,31345,KARAWANG,31515,TIRTAMULYA,18591,9294,27885
26141,JAWA BARAT,32193,KOTA BANDUNG,32219,ANDIR,28655,27537,56192
26141,JAWA BARAT,32193,KOTA BANDUNG,32319,ANTAPANI,25917,16876,42793
26141,JAWA BARAT,32193,KOTA BANDUNG,32339,ARCAMANIK,23917,16172,40089
26141,JAWA BARAT,32193,KOTA BANDUNG,32247,ASTANA ANYAR,20059,21995,42054
26141,JAWA BARAT,32193,KOTA BANDUNG,32206,BABAKAN CIPARAY,36500,35783,72283
26141,JAWA BARAT,32193,KOTA BANDUNG,32324,BANDUNG KIDUL,18936,12553,31489
26141,JAWA BARAT,32193,KOTA BANDUNG,32286,BANDUNG KULON,41286,30696,71982
26141,JAWA BARAT,32193,KOTA BANDUNG,32243,BANDUNG WETAN,8692,7826,16518
26141,JAWA BARAT,32193,KOTA BANDUNG,32262,BATUNUNGGAL,40037,27050,67087
26141,JAWA BARAT,32193,KOTA BANDUNG,32213,BOJONGLOA KALER,34855,32257,67112
26141,JAWA BARAT,32193,KOTA BANDUNG,32302,BOJONGLOA KIDUL,24017,23318,47335
26141,JAWA BARAT,32193,KOTA BANDUNG,32329,BUAHBATU,33299,20405,53704
26141,JAWA BARAT,32193,KOTA BANDUNG,32309,CIBEUNYING KALER,22881,15770,38651
26141,JAWA BARAT,32193,KOTA BANDUNG,32279,CIBEUNYING KIDUL,36894,24708,61602
26141,JAWA BARAT,32193,KOTA BANDUNG,32344,CIBIRU,25092,12619,37711
26141,JAWA BARAT,32193,KOTA BANDUNG,32226,CICENDO,28996,25276,54272
26141,JAWA BARAT,32193,KOTA BANDUNG,32239,CIDADAP,16777,13729,30506
26141,JAWA BARAT,32193,KOTA BANDUNG,32365,CINAMBO,8496,4349,12845
26141,JAWA BARAT,32193,KOTA BANDUNG,32199,COBLONG,38984,25687,64671
26141,JAWA BARAT,32193,KOTA BANDUNG,32355,GEDEBAGE,13205,6428,19633
26141,JAWA BARAT,32193,KOTA BANDUNG,32295,KIARACONDONG,44161,28147,72308
26141,JAWA BARAT,32193,KOTA BANDUNG,32271,LENGKONG,22918,17045,39963
26141,JAWA BARAT,32193,KOTA BANDUNG,32370,MANDALAJATI,23030,14068,37098
26141,JAWA BARAT,32193,KOTA BANDUNG,32360,PANYILEUKAN,14204,6699,20903
26141,JAWA BARAT,32193,KOTA BANDUNG,32334,RANCASARI,26610,16022,42632
26141,JAWA BARAT,32193,KOTA BANDUNG,32254,REGOL,23693,21675,45368
26141,JAWA BARAT,32193,KOTA BANDUNG,32233,SUKAJADI,31762,24987,56749
26141,JAWA BARAT,32193,KOTA BANDUNG,32194,SUKASARI,25632,18094,43726
26141,JAWA BARAT,32193,KOTA BANDUNG,32314,SUMUR BANDUNG,11017,8609,19626
26141,JAWA BARAT,32193,KOTA BANDUNG,32349,UJUNG BERUNG,28181,14642,42823
26141,JAWA BARAT,32646,KOTA BANJAR,32647,BANJAR,18978,13087,32065
26141,JAWA BARAT,32646,KOTA BANJAR,32669,LANGEN SARI,12508,15561,28069
26141,JAWA BARAT,32646,KOTA BANJAR,32655,PATARUMAN,17984,15160,33144
26141,JAWA BARAT,32646,KOTA BANJAR,32664,PURWAHARJA,7099,5856,12955
26141,JAWA BARAT,32403,KOTA BEKASI,32438,BANTAR GEBANG,27707,14303,42010
26141,JAWA BARAT,32403,KOTA BEKASI,32409,BEKASI BARAT,79543,67270,146813
26141,JAWA BARAT,32403,KOTA BEKASI,32422,BEKASI SELATAN,56601,50641,107242
26141,JAWA BARAT,32403,KOTA BEKASI,32404,BEKASI TIMUR,73480,64815,138295
26141,JAWA BARAT,32403,KOTA BEKASI,32415,BEKASI UTARA,96021,73139,169160
26141,JAWA BARAT,32403,KOTA BEKASI,32456,JATI SEMPURNA,26884,23834,50718
26141,JAWA BARAT,32403,KOTA BEKASI,32449,JATIASIH,62360,44480,106840
26141,JAWA BARAT,32403,KOTA BEKASI,32433,MEDAN SATRIA,43566,38727,82293
26141,JAWA BARAT,32403,KOTA BEKASI,32462,MUSTIKA JAYA,49876,36325,86201
26141,JAWA BARAT,32403,KOTA BEKASI,32443,PONDOK GEDE,66618,56454,123072
26141,JAWA BARAT,32403,KOTA BEKASI,32467,PONDOK MELATI,34176,35050,69226
26141,JAWA BARAT,32403,KOTA BEKASI,32428,RAWA LUMBU,54573,50487,105060
26141,JAWA BARAT,32077,KOTA BOGOR,32114,BOGOR BARAT,80800,45640,126440
26141,JAWA BARAT,32077,KOTA BOGOR,32078,BOGOR SELATAN,63572,40203,103775
26141,JAWA BARAT,32077,KOTA BOGOR,32102,BOGOR TENGAH,35204,24812,60016
26141,JAWA BARAT,32077,KOTA BOGOR,32095,BOGOR TIMUR,30962,24809,55771
26141,JAWA BARAT,32077,KOTA BOGOR,32131,BOGOR UTARA,59389,35076,94465
26141,JAWA BARAT,32077,KOTA BOGOR,32140,TANAH SAREAL,70359,40038,110397
26141,JAWA BARAT,32547,KOTA CIMAHI,32548,CIMAHI SELATAN,85382,43134,128516
26141,JAWA BARAT,32547,KOTA CIMAHI,32554,CIMAHI TENGAH,59660,28868,88528
26141,JAWA BARAT,32547,KOTA CIMAHI,32561,CIMAHI UTARA,53456,32237,85693
26141,JAWA BARAT,32375,KOTA CIREBON,32386,HARJAMUKTI,28150,28698,56848
26141,JAWA BARAT,32375,KOTA CIREBON,32376,KEJAKSAN,12058,12504,24562
26141,JAWA BARAT,32375,KOTA CIREBON,32397,KESAMBI,19626,19977,39603
26141,JAWA BARAT,32375,KOTA CIREBON,32381,LEMAH WUNGKUK,12261,18542,30803
26141,JAWA BARAT,32375,KOTA CIREBON,32392,PEKALIPAN,6264,11358,17622
26141,JAWA BARAT,32472,KOTA DEPOK,32507,BEJI,46679,35554,82233
26141,JAWA BARAT,32472,KOTA DEPOK,32539,BOJONGSARI,33956,23710,57666
26141,JAWA BARAT,32472,KOTA DEPOK,32520,CILODONG,41539,28362,69901
26141,JAWA BARAT,32472,KOTA DEPOK,32480,CIMANGGIS,67903,57582,125485
26141,JAWA BARAT,32472,KOTA DEPOK,32526,CINERE,25097,25017,50114
26141,JAWA BARAT,32472,KOTA DEPOK,32514,CIPAYUNG,42982,28859,71841
26141,JAWA BARAT,32472,KOTA DEPOK,32495,LIMO,24486,21754,46240
26141,JAWA BARAT,32472,KOTA DEPOK,32473,PANCORAN MAS,65651,55245,120896
26141,JAWA BARAT,32472,KOTA DEPOK,32487,SAWANGAN,45597,27542,73139
26141,JAWA BARAT,32472,KOTA DEPOK,32500,SUKMAJAYA,72187,58823,131010
26141,JAWA BARAT,32472,KOTA DEPOK,32531,TAPOS,77207,50247,127454
26141,JAWA BARAT,32152,KOTA SUKABUMI,32177,BAROS,13394,4363,17757
26141,JAWA BARAT,32152,KOTA SUKABUMI,32188,CIBEUREUM,14888,4928,19816
26141,JAWA BARAT,32152,KOTA SUKABUMI,32158,CIKOLE,21602,11405,33007
26141,JAWA BARAT,32152,KOTA SUKABUMI,32165,CITAMIANG,19578,7873,27451
26141,JAWA BARAT,32152,KOTA SUKABUMI,32153,GUNUNG PUYUH,17890,6826,24716
26141,JAWA BARAT,32152,KOTA SUKABUMI,32182,LEMBURSITU,13643,6666,20309
26141,JAWA BARAT,32152,KOTA SUKABUMI,32171,WARUDOYONG,19123,11009,30132
26141,JAWA BARAT,32566,KOTA TASIKMALAYA,32631,BUNGURSARI,20866,7088,27954
26141,JAWA BARAT,32566,KOTA TASIKMALAYA,32603,CIBEUREUM,28649,8063,36712
26141,JAWA BARAT,32566,KOTA TASIKMALAYA,32567,CIHIDEUNG,25963,16277,42240
26141,JAWA BARAT,32566,KOTA TASIKMALAYA,32574,CIPEDES,33848,11706,45554
26141,JAWA BARAT,32566,KOTA TASIKMALAYA,32585,INDIHIANG,22235,6874,29109
26141,JAWA BARAT,32566,KOTA TASIKMALAYA,32592,KAWALU,38167,11917,50084
26141,JAWA BARAT,32566,KOTA TASIKMALAYA,32622,MANGKUBUMI,38334,12700,51034
26141,JAWA BARAT,32566,KOTA TASIKMALAYA,32639,PURBARATU,18967,5377,24344
26141,JAWA BARAT,32566,KOTA TASIKMALAYA,32613,TAMANSARI,28315,8268,36583
26141,JAWA BARAT,32566,KOTA TASIKMALAYA,32579,TAWANG,26321,11037,37358
26141,JAWA BARAT,28960,KUNINGAN,29082,CIAWIGEBANG,22506,17356,39862
26141,JAWA BARAT,28960,KUNINGAN,29308,CIBEUREUM,4879,5551,10430
26141,JAWA BARAT,28960,KUNINGAN,29005,CIBINGBIN,9633,8669,18302
26141,JAWA BARAT,28960,KUNINGAN,29107,CIDAHU,10327,9357,19684
26141,JAWA BARAT,28960,KUNINGAN,29357,CIGANDAMEKAR,8070,7560,15630
26141,JAWA BARAT,28960,KUNINGAN,29206,CIGUGUR,15165,11091,26256
26141,JAWA BARAT,28960,KUNINGAN,29284,CILEBAK,3887,2589,6476
26141,JAWA BARAT,28960,KUNINGAN,29136,CILIMUS,14394,11998,26392
26141,JAWA BARAT,28960,KUNINGAN,29273,CIMAHI,5934,8582,14516
26141,JAWA BARAT,28960,KUNINGAN,28974,CINIRU,6094,3681,9775
26141,JAWA BARAT,28960,KUNINGAN,29237,CIPICUNG,6167,6571,12738
26141,JAWA BARAT,28960,KUNINGAN,28992,CIWARU,8230,6220,14450
26141,JAWA BARAT,28960,KUNINGAN,29186,DARMA,14967,9838,24805
26141,JAWA BARAT,28960,KUNINGAN,29047,GARAWANGI,11905,8335,20240
26141,JAWA BARAT,28960,KUNINGAN,29292,HANTARA,3871,3643,7514
26141,JAWA BARAT,28960,KUNINGAN,29120,JALAKSANA,11950,13142,25092
26141,JAWA BARAT,28960,KUNINGAN,29262,JAPARA,4781,5740,10521
26141,JAWA BARAT,28960,KUNINGAN,28961,KADUGEDE,8638,6066,14704
26141,JAWA BARAT,28960,KUNINGAN,29301,KALIMANGGIS,5271,5278,10549
26141,JAWA BARAT,28960,KUNINGAN,29317,KARANG KANCANA,4947,4503,9450
26141,JAWA BARAT,28960,KUNINGAN,29171,KRAMATMULYA,11438,10574,22012
26141,JAWA BARAT,28960,KUNINGAN,29065,KUNINGAN,35885,21691,57576
26141,JAWA BARAT,28960,KUNINGAN,29033,LEBAKWANGI,10753,10202,20955
26141,JAWA BARAT,28960,KUNINGAN,29016,LURAGUNG,13046,9025,22071
26141,JAWA BARAT,28960,KUNINGAN,29327,MALEBER,13430,6444,19874
26141,JAWA BARAT,28960,KUNINGAN,29150,MANDIRANCAN,7015,5121,12136
26141,JAWA BARAT,28960,KUNINGAN,29228,NUSAHERANG,4992,5644,10636
26141,JAWA BARAT,28960,KUNINGAN,29248,PANCALANG,6370,5577,11947
26141,JAWA BARAT,28960,KUNINGAN,29217,PASAWAHAN,5991,6443,12434
26141,JAWA BARAT,28960,KUNINGAN,29163,SELAJAMBE,4323,3705,8028
26141,JAWA BARAT,28960,KUNINGAN,29344,SINDANG AGUNG,9800,8197,17997
26141,JAWA BARAT,28960,KUNINGAN,28984,SUBANG,7343,1763,9106
26141,JAWA BARAT,29834,MAJALENGKA,29899,ARGAPURA,0,0,0
26141,JAWA BARAT,29834,MAJALENGKA,30139,BANJARAN,0,0,0
26141,JAWA BARAT,29834,MAJALENGKA,29852,BANTARUJEG,0,0,0
26141,JAWA BARAT,29834,MAJALENGKA,30117,CIGASONG,0,0,0
26141,JAWA BARAT,29834,MAJALENGKA,29866,CIKIJING,0,0,0
26141,JAWA BARAT,29834,MAJALENGKA,30153,CINGAMBUL,0,0,0
26141,JAWA BARAT,29834,MAJALENGKA,30008,DAWUAN,0,0,0
26141,JAWA BARAT,29834,MAJALENGKA,30043,JATITUJUH,0,0,0
26141,JAWA BARAT,29834,MAJALENGKA,29991,JATIWANGI,0,0,0
26141,JAWA BARAT,29834,MAJALENGKA,30020,KADIPATEN,0,0,0
26141,JAWA BARAT,29834,MAJALENGKA,30167,KASOKANDEL,0,0,0
26141,JAWA BARAT,29834,MAJALENGKA,30028,KERTAJATI,0,0,0
26141,JAWA BARAT,29834,MAJALENGKA,29835,LEMAHSUGIH,0,0,0
26141,JAWA BARAT,29834,MAJALENGKA,29976,LEUWIMUNDING,0,0,0
26141,JAWA BARAT,29834,MAJALENGKA,30059,LIGUNG,0,0,0
26141,JAWA BARAT,29834,MAJALENGKA,29914,MAJA,0,0,0
26141,JAWA BARAT,29834,MAJALENGKA,29933,MAJALENGKA,0,0,0
26141,JAWA BARAT,29834,MAJALENGKA,30186,MALAUSMA,0,0,0
26141,JAWA BARAT,29834,MAJALENGKA,30103,PALASAH,0,0,0
26141,JAWA BARAT,29834,MAJALENGKA,30093,PANYINGKIRAN,0,0,0
26141,JAWA BARAT,29834,MAJALENGKA,29962,RAJAGALUH,0,0,0
26141,JAWA BARAT,29834,MAJALENGKA,30178,SINDANG,0,0,0
26141,JAWA BARAT,29834,MAJALENGKA,30128,SINDANGWANGI,0,0,0
26141,JAWA BARAT,29834,MAJALENGKA,29948,SUKAHAJI,0,0,0
26141,JAWA BARAT,29834,MAJALENGKA,30079,SUMBERJAYA,0,0,0
26141,JAWA BARAT,29834,MAJALENGKA,29882,TALAGA,0,0,0
26141,JAWA BARAT,31135,PURWAKARTA,31284,BABAKANCIKAO,18929,10049,28978
26141,JAWA BARAT,31135,PURWAKARTA,31269,BOJONG,18528,6826,25354
26141,JAWA BARAT,31135,PURWAKARTA,31294,BUNGURSARI,20520,8634,29154
26141,JAWA BARAT,31135,PURWAKARTA,31147,CAMPAKA,17318,7361,24679
26141,JAWA BARAT,31135,PURWAKARTA,31305,CIBATU,11603,6094,17697
26141,JAWA BARAT,31135,PURWAKARTA,31201,DARANGDAN,24669,9197,33866
26141,JAWA BARAT,31135,PURWAKARTA,31158,JATILUHUR,25653,9773,35426
26141,JAWA BARAT,31135,PURWAKARTA,31334,KIARAPEDES,9606,5075,14681
26141,JAWA BARAT,31135,PURWAKARTA,31217,MANIIS,9378,5677,15055
26141,JAWA BARAT,31135,PURWAKARTA,31256,PASAWAHAN,18701,7078,25779
26141,JAWA BARAT,31135,PURWAKARTA,31169,PLERED,28673,8135,36808
26141,JAWA BARAT,31135,PURWAKARTA,31322,PONDOKSALAM,11799,4409,16208
26141,JAWA BARAT,31135,PURWAKARTA,31136,PURWAKARTA,66104,27283,93387
26141,JAWA BARAT,31135,PURWAKARTA,31316,SUKASARI,5497,1952,7449
26141,JAWA BARAT,31135,PURWAKARTA,31186,SUKATANI,25873,8689,34562
26141,JAWA BARAT,31135,PURWAKARTA,31226,TEGALWARU,18564,5632,24196
26141,JAWA BARAT,31135,PURWAKARTA,31240,WANAYASA,15844,6393,22237
26141,JAWA BARAT,30851,SUBANG,30921,BINONG,10487,16397,26884
26141,JAWA BARAT,30851,SUBANG,30966,BLANAKAN,12619,21173,33792
26141,JAWA BARAT,30851,SUBANG,30931,CIASEM,24950,31011,55961
26141,JAWA BARAT,30851,SUBANG,31118,CIATER,10547,6396,16943
26141,JAWA BARAT,30851,SUBANG,31007,CIBOGO,11659,13304,24963
26141,JAWA BARAT,30851,SUBANG,31028,CIJAMBE,12697,10681,23378
26141,JAWA BARAT,30851,SUBANG,31053,CIKAUM,0,0,0
26141,JAWA BARAT,30851,SUBANG,31037,CIPEUNDUEY,13169,12726,25895
26141,JAWA BARAT,30851,SUBANG,31017,CIPUNAGARA,13023,21641,34664
26141,JAWA BARAT,30851,SUBANG,30860,CISALAK,14383,7405,21788
26141,JAWA BARAT,30851,SUBANG,30987,COMPRENG,8636,16198,24834
26141,JAWA BARAT,30851,SUBANG,31097,DAWUAN,12038,11779,23817
26141,JAWA BARAT,30851,SUBANG,30958,JALANCAGAK,14437,10464,24901
26141,JAWA BARAT,30851,SUBANG,30879,KALIJATI,18424,15716,34140
26141,JAWA BARAT,30851,SUBANG,31088,KASOMALANG,15433,7116,22549
26141,JAWA BARAT,30851,SUBANG,31045,LEGONKULON,5194,7827,13021
26141,JAWA BARAT,30851,SUBANG,30890,PABUARAN,18201,16083,34284
26141,JAWA BARAT,30851,SUBANG,30910,PAGADEN,17480,17404,34884
26141,JAWA BARAT,30851,SUBANG,31108,PAGADEN BARAT,10978,12013,22991
26141,JAWA BARAT,30851,SUBANG,30949,PAMANUKAN,12292,19202,31494
26141,JAWA BARAT,30851,SUBANG,30996,PATOKBEUSI,23878,19507,43385
26141,JAWA BARAT,30851,SUBANG,30899,PURWADADI,15399,18221,33620
26141,JAWA BARAT,30851,SUBANG,31126,PUSAKAJAYA,9059,16042,25101
26141,JAWA BARAT,30851,SUBANG,30941,PUSAKANAGARA,6908,14810,21718
26141,JAWA BARAT,30851,SUBANG,30852,SAGALAHERANG,10843,7024,17867
26141,JAWA BARAT,30851,SUBANG,31063,SERANGPANJANG,6993,7502,14495
26141,JAWA BARAT,30851,SUBANG,30870,SUBANG,39761,31952,71713
26141,JAWA BARAT,30851,SUBANG,31070,SUKASARI,8463,14947,23410
26141,JAWA BARAT,30851,SUBANG,31078,TAMBAKDAHAN,9266,16125,25391
26141,JAWA BARAT,30851,SUBANG,30976,TANJUNGSIANG,14835,11258,26093
26141,JAWA BARAT,26611,SUKABUMI,26637,BANTAR GADUNG,10444,5410,15854
26141,JAWA BARAT,26611,SUKABUMI,26740,BOJONG GENTENG,14540,3557,18097
26141,JAWA BARAT,26611,SUKABUMI,26893,CARINGIN,17089,4643,21732
26141,JAWA BARAT,26611,SUKABUMI,27020,CIAMBAR,14021,4480,18501
26141,JAWA BARAT,26611,SUKABUMI,26709,CIBADAK,38418,16815,55233
26141,JAWA BARAT,26611,SUKABUMI,26837,CIBITUNG,7843,4725,12568
26141,JAWA BARAT,26611,SUKABUMI,26861,CICANTAYAN,22413,6537,28950
26141,JAWA BARAT,26611,SUKABUMI,26753,CICURUG,44985,19284,64269
26141,JAWA BARAT,26611,SUKABUMI,26999,CIDADAP,5974,4702,10676
26141,JAWA BARAT,26611,SUKABUMI,26767,CIDAHU,23638,6806,30444
26141,JAWA BARAT,26611,SUKABUMI,26993,CIDOLOG,5690,4355,10045
26141,JAWA BARAT,26611,SUKABUMI,26808,CIEMAS,13933,10864,24797
26141,JAWA BARAT,26611,SUKABUMI,26628,CIKAKAK,10342,7104,17446
26141,JAWA BARAT,26611,SUKABUMI,26699,CIKEMBAR,30001,14115,44116
26141,JAWA BARAT,26611,SUKABUMI,26657,CIKIDANG,16104,9787,25891
26141,JAWA BARAT,26611,SUKABUMI,27013,CIMANGGU,7518,2940,10458
26141,JAWA BARAT,26611,SUKABUMI,26844,CIRACAP,12743,12957,25700
26141,JAWA BARAT,26611,SUKABUMI,26926,CIREUNGHAS,11934,3966,15900
26141,JAWA BARAT,26611,SUKABUMI,26869,CISAAT,49493,13342,62835
26141,JAWA BARAT,26611,SUKABUMI,26645,CISOLOK,17889,14646,32535
26141,JAWA BARAT,26611,SUKABUMI,26986,CURUG KEMBAR,8977,6652,15629
26141,JAWA BARAT,26611,SUKABUMI,26966,GEGER BITUNG,13345,6643,19988
26141,JAWA BARAT,26611,SUKABUMI,26853,GUNUNG GURUH,16696,10206,26902
26141,JAWA BARAT,26611,SUKABUMI,26797,JAMPANG KULON,14634,6655,21289
26141,JAWA BARAT,26611,SUKABUMI,26676,JAMPANG TENGAH,21654,12415,34069
26141,JAWA BARAT,26611,SUKABUMI,26784,KABANDUNGAN,11733,5710,17443
26141,JAWA BARAT,26611,SUKABUMI,26883,KADUDAMPIT,23036,4405,27441
26141,JAWA BARAT,26611,SUKABUMI,26776,KALAPA NUNGGAL,17602,4919,22521
26141,JAWA BARAT,26611,SUKABUMI,26817,KALIBUNDER,9238,3862,13100
26141,JAWA BARAT,26611,SUKABUMI,26920,KEBON PEDES,12296,3605,15901
26141,JAWA BARAT,26611,SUKABUMI,26670,LENGKONG,8482,4949,13431
26141,JAWA BARAT,26611,SUKABUMI,26720,NAGRAK,27516,15483,42999
26141,JAWA BARAT,26611,SUKABUMI,26955,NYALINDUNG,17027,8251,25278
26141,JAWA BARAT,26611,SUKABUMI,26939,PABUARAN,13497,5910,19407
26141,JAWA BARAT,26611,SUKABUMI,26746,PARAKAN SALAK,16409,4586,20995
26141,JAWA BARAT,26611,SUKABUMI,26731,PARUNG KUDA,25828,9301,35129
26141,JAWA BARAT,26611,SUKABUMI,26612,PELABUHAN RATU,31467,18743,50210
26141,JAWA BARAT,26611,SUKABUMI,26947,PURABAYA,12734,7994,20728
26141,JAWA BARAT,26611,SUKABUMI,26974,SAGARANTEN,16677,9050,25727
26141,JAWA BARAT,26611,SUKABUMI,26621,SIMPENAN,16730,9556,26286
26141,JAWA BARAT,26611,SUKABUMI,26903,SUKABUMI,19933,6929,26862
26141,JAWA BARAT,26611,SUKABUMI,26932,SUKALARANG,10061,7749,17810
26141,JAWA BARAT,26611,SUKABUMI,26910,SUKARAJA,29368,11969,41337
26141,JAWA BARAT,26611,SUKABUMI,26825,SURADE,22275,13833,36108
26141,JAWA BARAT,26611,SUKABUMI,27004,TEGALBULEUD,10384,8152,18536
26141,JAWA BARAT,26611,SUKABUMI,26791,WALURAN,8082,5091,13173
26141,JAWA BARAT,26611,SUKABUMI,26688,WARUNG KIARA,19109,9274,28383
26141,JAWA BARAT,30197,SUMEDANG,30304,BUAHDUA,10136,10231,20367
26141,JAWA BARAT,30197,SUMEDANG,30237,CIBUGEL,6688,4613,11301
26141,JAWA BARAT,30197,SUMEDANG,30447,CIMALAKA,20547,13680,34227
26141,JAWA BARAT,30197,SUMEDANG,30352,CIMANGGUNG,37363,9987,47350
26141,JAWA BARAT,30197,SUMEDANG,30462,CISARUA,4985,5547,10532
26141,JAWA BARAT,30197,SUMEDANG,30245,CISITU,8903,7274,16177
26141,JAWA BARAT,30197,SUMEDANG,30271,CONGGEANG,8921,10081,19002
26141,JAWA BARAT,30197,SUMEDANG,30220,DARMARAJA,11863,9235,21098
26141,JAWA BARAT,30197,SUMEDANG,30417,GANEAS,8583,5009,13592
26141,JAWA BARAT,30197,SUMEDANG,30490,JATIGEDE,8211,7324,15535
26141,JAWA BARAT,30197,SUMEDANG,30364,JATINANGOR,37890,14635,52525
26141,JAWA BARAT,30197,SUMEDANG,30210,JATINUNGGAL,14850,9438,24288
26141,JAWA BARAT,30197,SUMEDANG,30340,PAMULIHAN,20302,12927,33229
26141,JAWA BARAT,30197,SUMEDANG,30284,PASEH,10476,11184,21660
26141,JAWA BARAT,30197,SUMEDANG,30377,RANCAKALONG,13189,10775,23964
26141,JAWA BARAT,30197,SUMEDANG,30256,SITURAJA,14367,8144,22511
26141,JAWA BARAT,30197,SUMEDANG,30332,SUKASARI,13736,6357,20093
26141,JAWA BARAT,30197,SUMEDANG,30388,SUMEDANG SELATAN,31073,15435,46508
26141,JAWA BARAT,30197,SUMEDANG,30403,SUMEDANG UTARA,33312,19340,52652
26141,JAWA BARAT,30197,SUMEDANG,30295,SURIAN,3244,4012,7256
26141,JAWA BARAT,30197,SUMEDANG,30425,TANJUNGKERTA,12391,8037,20428
26141,JAWA BARAT,30197,SUMEDANG,30437,TANJUNGMEDAR,7977,7326,15303
26141,JAWA BARAT,30197,SUMEDANG,30319,TANJUNGSARI,33471,13838,47309
26141,JAWA BARAT,30197,SUMEDANG,30470,TOMO,7338,7831,15169
26141,JAWA BARAT,30197,SUMEDANG,30480,UJUNGJAYA,8559,10523,19082
26141,JAWA BARAT,30197,SUMEDANG,30198,WADO,13472,9410,22882
26141,JAWA BARAT,28182,TASIKMALAYA,28266,BANTARKALONG,14565,4525,19090
26141,JAWA BARAT,28182,TASIKMALAYA,28275,BOJONGASIH,7889,2490,10379
26141,JAWA BARAT,28182,TASIKMALAYA,28288,BOJONGGAMBIR,14580,5705,20285
26141,JAWA BARAT,28182,TASIKMALAYA,28534,CIAWI,20339,10823,31162
26141,JAWA BARAT,28182,TASIKMALAYA,28250,CIBALONG,12418,6320,18738
26141,JAWA BARAT,28182,TASIKMALAYA,28445,CIGALONTANG,27924,9978,37902
26141,JAWA BARAT,28182,TASIKMALAYA,28214,CIKALONG,23505,10269,33774
26141,JAWA BARAT,28182,TASIKMALAYA,28240,CIKATOMAS,19550,7739,27289
26141,JAWA BARAT,28182,TASIKMALAYA,28383,CINEAM,12674,7706,20380
26141,JAWA BARAT,28182,TASIKMALAYA,28183,CIPATUJAH,19862,15457,35319
26141,JAWA BARAT,28182,TASIKMALAYA,28494,CISAYONG,18425,11092,29517
26141,JAWA BARAT,28182,TASIKMALAYA,28282,CULAMEGA,9884,2500,12384
26141,JAWA BARAT,28182,TASIKMALAYA,28412,GUNUNG TANJUNG,11912,3273,15185
26141,JAWA BARAT,28182,TASIKMALAYA,28525,JAMANIS,12367,4476,16843
26141,JAWA BARAT,28182,TASIKMALAYA,28371,JATIWARAS,18085,6046,24131
26141,JAWA BARAT,28182,TASIKMALAYA,28546,KADIPATEN,13792,3098,16890
26141,JAWA BARAT,28182,TASIKMALAYA,28394,KARANG JAYA,4317,3356,7673
26141,JAWA BARAT,28182,TASIKMALAYA,28199,KARANGNUNGGAL,28840,15904,44744
26141,JAWA BARAT,28182,TASIKMALAYA,28462,LEUWISARI,13799,5599,19398
26141,JAWA BARAT,28182,TASIKMALAYA,28431,MANGUNREJA,14149,5986,20135
26141,JAWA BARAT,28182,TASIKMALAYA,28399,MANONJAYA,25975,8483,34458
26141,JAWA BARAT,28182,TASIKMALAYA,28470,PADAKEMBANG,13269,6229,19498
26141,JAWA BARAT,28182,TASIKMALAYA,28553,PAGERAGEUNG,21939,6145,28084
26141,JAWA BARAT,28182,TASIKMALAYA,28228,PANCA TENGAH,18620,5382,24002
26141,JAWA BARAT,28182,TASIKMALAYA,28257,PARUNGPONTENG,15518,3423,18941
26141,JAWA BARAT,28182,TASIKMALAYA,28335,PUSPAHIANG,9132,9192,18324
26141,JAWA BARAT,28182,TASIKMALAYA,28516,RAJAPOLAH,17618,6936,24554
26141,JAWA BARAT,28182,TASIKMALAYA,28322,SALAWU,22298,9920,32218
26141,JAWA BARAT,28182,TASIKMALAYA,28361,SALOPA,15122,7686,22808
26141,JAWA BARAT,28182,TASIKMALAYA,28476,SARIWANGI,12961,3259,16220
26141,JAWA BARAT,28182,TASIKMALAYA,28420,SINGAPARNA,24243,11663,35906
26141,JAWA BARAT,28182,TASIKMALAYA,28299,SODONGHILIR,27537,5986,33523
26141,JAWA BARAT,28182,TASIKMALAYA,28508,SUKAHENING,9122,6232,15354
26141,JAWA BARAT,28182,TASIKMALAYA,28352,SUKARAJA,19855,7461,27316
26141,JAWA BARAT,28182,TASIKMALAYA,28438,SUKARAME,15518,4767,20285
26141,JAWA BARAT,28182,TASIKMALAYA,28485,SUKARATU,16205,7228,23433
26141,JAWA BARAT,28182,TASIKMALAYA,28564,SUKARESIK,14160,3843,18003
26141,JAWA BARAT,28182,TASIKMALAYA,28344,TANJUNGJAYA,17264,5271,22535
26141,JAWA BARAT,28182,TASIKMALAYA,28312,TARAJU,12523,7120,19643
32676,JAWA TENGAH,33603,BANJARNEGARA,33730,BANJARMANGU,10445,14949,25394
32676,JAWA TENGAH,33603,BANJARNEGARA,33679,BANJARNEGARA,17746,20147,37893
32676,JAWA TENGAH,33603,BANJARNEGARA,33839,BATUR,9298,11097,20395
32676,JAWA TENGAH,33603,BANJARNEGARA,33660,BAWANG,13130,19371,32501
32676,JAWA TENGAH,33603,BANJARNEGARA,33866,KALIBENING,8477,14232,22709
32676,JAWA TENGAH,33603,BANJARNEGARA,33790,KARANGKOBAR,7129,9373,16502
32676,JAWA TENGAH,33603,BANJARNEGARA,33709,MADUKARA,11070,15521,26591
32676,JAWA TENGAH,33603,BANJARNEGARA,33629,MANDIRAJA,10397,28500,38897
32676,JAWA TENGAH,33603,BANJARNEGARA,33892,PAGEDONGAN,5590,13914,19504
32676,JAWA TENGAH,33603,BANJARNEGARA,33804,PAGENTAN,9118,11668,20786
32676,JAWA TENGAH,33603,BANJARNEGARA,33883,PANDANARUM,2995,8403,11398
32676,JAWA TENGAH,33603,BANJARNEGARA,33821,PEJAWARAN,11927,11288,23215
32676,JAWA TENGAH,33603,BANJARNEGARA,33772,PUNGGELAN,13062,25992,39054
32676,JAWA TENGAH,33603,BANJARNEGARA,33646,PURWONEGORO,12581,27956,40537
32676,JAWA TENGAH,33603,BANJARNEGARA,33620,PURWOREJO KLAMPOK,7931,16308,24239
32676,JAWA TENGAH,33603,BANJARNEGARA,33760,RAKIT,11091,16787,27878
32676,JAWA TENGAH,33603,BANJARNEGARA,33693,SIGALUH,6561,11520,18081
32676,JAWA TENGAH,33603,BANJARNEGARA,33604,SUSUKAN,8424,21251,29675
32676,JAWA TENGAH,33603,BANJARNEGARA,33748,WANADADI,8648,8755,17403
32676,JAWA TENGAH,33603,BANJARNEGARA,33848,WANAYASA,11278,15366,26644
32676,JAWA TENGAH,32986,BANYUMAS,33151,AJIBARANG,0,0,0
32676,JAWA TENGAH,32986,BANYUMAS,33113,BANYUMAS,0,0,0
32676,JAWA TENGAH,32986,BANYUMAS,33286,BATURADEN,0,0,0
32676,JAWA TENGAH,32986,BANYUMAS,33195,CILONGOK,0,0,0
32676,JAWA TENGAH,32986,BANYUMAS,33167,GUMELAR,0,0,0
32676,JAWA TENGAH,32986,BANYUMAS,33011,JATILAWANG,0,0,0
32676,JAWA TENGAH,32986,BANYUMAS,33100,KALIBAGOR,0,0,0
32676,JAWA TENGAH,32986,BANYUMAS,33216,KARANG LEWAS,0,0,0
32676,JAWA TENGAH,32986,BANYUMAS,33033,KEBASEN,0,0,0
32676,JAWA TENGAH,32986,BANYUMAS,33299,KEDUNG BANTENG,0,0,0
32676,JAWA TENGAH,32986,BANYUMAS,33249,KEMBARAN,0,0,0
32676,JAWA TENGAH,32986,BANYUMAS,33046,KEMRANJEN,0,0,0
32676,JAWA TENGAH,32986,BANYUMAS,32987,LUMBIR,0,0,0
32676,JAWA TENGAH,32986,BANYUMAS,33126,PATIKRAJA,0,0,0
32676,JAWA TENGAH,32986,BANYUMAS,33178,PEKUNCEN,0,0,0
32676,JAWA TENGAH,32986,BANYUMAS,33140,PURWOJATI,0,0,0
32676,JAWA TENGAH,32986,BANYUMAS,33322,PURWOKERTO BARAT,0,0,0
32676,JAWA TENGAH,32986,BANYUMAS,33314,PURWOKERTO SELATAN,0,0,0
32676,JAWA TENGAH,32986,BANYUMAS,33330,PURWOKERTO TIMUR,0,0,0
32676,JAWA TENGAH,32986,BANYUMAS,33337,PURWOKERTO UTARA,0,0,0
32676,JAWA TENGAH,32986,BANYUMAS,33023,RAWALO,0,0,0
32676,JAWA TENGAH,32986,BANYUMAS,33230,SOKARAJA,0,0,0
32676,JAWA TENGAH,32986,BANYUMAS,33090,SOMAGEDE,0,0,0
32676,JAWA TENGAH,32986,BANYUMAS,33266,SUMBANG,0,0,0
32676,JAWA TENGAH,32986,BANYUMAS,33062,SUMPIUH,0,0,0
32676,JAWA TENGAH,32986,BANYUMAS,33077,TAMBAK,0,0,0
32676,JAWA TENGAH,32986,BANYUMAS,32998,WANGON,0,0,0
32676,JAWA TENGAH,40053,BATANG,40070,BANDAR,11790,22628,34418
32676,JAWA TENGAH,40053,BATANG,40305,BANYUPUTIH,5860,14284,20144
32676,JAWA TENGAH,40053,BATANG,40239,BATANG,26277,46083,72360
32676,JAWA TENGAH,40053,BATANG,40127,BAWANG,9845,19271,29116
32676,JAWA TENGAH,40053,BATANG,40088,BLADO,8343,14243,22586
32676,JAWA TENGAH,40053,BATANG,40169,GRINGSING,11492,22122,33614
32676,JAWA TENGAH,40053,BATANG,40280,KANDEMAN,7706,19191,26897
32676,JAWA TENGAH,40053,BATANG,40185,LIMPUNG,8581,16141,24722
32676,JAWA TENGAH,40053,BATANG,40294,PECALUNGAN,6124,11138,17262
32676,JAWA TENGAH,40053,BATANG,40107,REBAN,7790,13289,21079
32676,JAWA TENGAH,40053,BATANG,40203,SUBAH,9782,21225,31007
32676,JAWA TENGAH,40053,BATANG,40148,TERSONO,9443,13338,22781
32676,JAWA TENGAH,40053,BATANG,40221,TULIS,6546,14175,20721
32676,JAWA TENGAH,40053,BATANG,40261,WARUNGASEM,8196,19604,27800
32676,JAWA TENGAH,40053,BATANG,40054,WONOTUNGGAL,7244,11974,19218
32676,JAWA TENGAH,37514,BLORA,37688,BANJAREJO,9915,23146,33061
32676,JAWA TENGAH,37514,BLORA,37643,BLORA,17306,36975,54281
32676,JAWA TENGAH,37514,BLORA,37792,BOGOREJO,4608,10353,14961
32676,JAWA TENGAH,37514,BLORA,37576,CEPU,17183,26112,43295
32676,JAWA TENGAH,37514,BLORA,37807,JAPAH,5611,14762,20373
32676,JAWA TENGAH,37514,BLORA,37515,JATI,7985,20211,28196
32676,JAWA TENGAH,37514,BLORA,37617,JEPON,11059,25040,36099
32676,JAWA TENGAH,37514,BLORA,37605,JIKEN,8277,14033,22310
32676,JAWA TENGAH,37514,BLORA,37558,KEDUNGTUBAN,12561,19001,31562
32676,JAWA TENGAH,37514,BLORA,37547,KRADENAN,8749,14372,23121
32676,JAWA TENGAH,37514,BLORA,37739,KUNDURAN,10510,26782,37292
32676,JAWA TENGAH,37514,BLORA,37709,NGAWEN,9861,22473,32334
32676,JAWA TENGAH,37514,BLORA,37528,RANDUBLATUNG,17055,26235,43290
32676,JAWA TENGAH,37514,BLORA,37594,SAMBONG,6789,9135,15924
32676,JAWA TENGAH,37514,BLORA,37766,TODANAN,8624,28624,37248
32676,JAWA TENGAH,37514,BLORA,37672,TUNJUNGAN,8613,17922,26535
32676,JAWA TENGAH,35575,BOYOLALI,35587,AMPEL,0,0,0
32676,JAWA TENGAH,35575,BOYOLALI,35801,ANDONG,0,0,0
32676,JAWA TENGAH,35575,BOYOLALI,35696,BANYUDONO,0,0,0
32676,JAWA TENGAH,35575,BOYOLALI,35645,BOYOLALI,0,0,0
32676,JAWA TENGAH,35575,BOYOLALI,35608,CEPOGO,0,0,0
32676,JAWA TENGAH,35575,BOYOLALI,35851,JUWANGI,0,0,0
32676,JAWA TENGAH,35575,BOYOLALI,35770,KARANGGEDE,0,0,0
32676,JAWA TENGAH,35575,BOYOLALI,35818,KEMUSU,0,0,0
32676,JAWA TENGAH,35575,BOYOLALI,35787,KLEGO,0,0,0
32676,JAWA TENGAH,35575,BOYOLALI,35655,MOJOSONGO,0,0,0
32676,JAWA TENGAH,35575,BOYOLALI,35624,MUSUK,0,0,0
32676,JAWA TENGAH,35575,BOYOLALI,35729,NGEMPLAK,0,0,0
32676,JAWA TENGAH,35575,BOYOLALI,35742,NOGOSARI,0,0,0
32676,JAWA TENGAH,35575,BOYOLALI,35712,SAMBI,0,0,0
32676,JAWA TENGAH,35575,BOYOLALI,35683,SAWIT,0,0,0
32676,JAWA TENGAH,35575,BOYOLALI,35576,SELO,0,0,0
32676,JAWA TENGAH,35575,BOYOLALI,35756,SIMO,0,0,0
32676,JAWA TENGAH,35575,BOYOLALI,35669,TERAS,0,0,0
32676,JAWA TENGAH,35575,BOYOLALI,35832,WONOSEGORO,0,0,0
32676,JAWA TENGAH,41165,BREBES,41454,BANJARHARJO,19197,39128,58325
32676,JAWA TENGAH,41165,BREBES,41188,BANTARKAWUNG,19423,28090,47513
32676,JAWA TENGAH,41165,BREBES,41309,BREBES,30887,53922,84809
32676,JAWA TENGAH,41165,BREBES,41400,BULAKAMBA,22243,55794,78037
32676,JAWA TENGAH,41165,BREBES,41207,BUMIAYU,24154,29444,53598
32676,JAWA TENGAH,41165,BREBES,41265,JATIBARANG,16384,26810,43194
32676,JAWA TENGAH,41165,BREBES,41344,KERSANA,10020,23549,33569
32676,JAWA TENGAH,41165,BREBES,41432,KETANGGUNGAN,26046,42651,68697
32676,JAWA TENGAH,41165,BREBES,41420,LARANGAN,22164,56845,79009
32676,JAWA TENGAH,41165,BREBES,41358,LOSARI,19741,44362,64103
32676,JAWA TENGAH,41165,BREBES,41223,PAGUYANGAN,16461,33550,50011
32676,JAWA TENGAH,41165,BREBES,41166,SALEM,14237,18963,33200
32676,JAWA TENGAH,41165,BREBES,41236,SIRAMPOG,14264,16062,30326
32676,JAWA TENGAH,41165,BREBES,41333,SONGGOM,11284,25903,37187
32676,JAWA TENGAH,41165,BREBES,41381,TANJUNG,12520,35281,47801
32676,JAWA TENGAH,41165,BREBES,41250,TONJONG,16354,16615,32969
32676,JAWA TENGAH,41165,BREBES,41288,WANASARI,22596,54137,76733
32676,JAWA TENGAH,32677,CILACAP,32707,ADIPALA,0,0,0
32676,JAWA TENGAH,32677,CILACAP,83531,BANTARSARI,0,0,0
32676,JAWA TENGAH,32677,CILACAP,32724,BINANGUN,0,0,0
32676,JAWA TENGAH,32677,CILACAP,83532,CILACAP SELATAN,0,0,0
32676,JAWA TENGAH,32677,CILACAP,83533,CILACAP TENGAH,0,0,0
32676,JAWA TENGAH,32677,CILACAP,83534,CILACAP UTARA,0,0,0
32676,JAWA TENGAH,32677,CILACAP,32857,CIMANGGU,0,0,0
32676,JAWA TENGAH,32677,CILACAP,83529,CIPARI,0,0,0
32676,JAWA TENGAH,32677,CILACAP,83527,DAYEUHLUHUR,0,0,0
32676,JAWA TENGAH,32677,CILACAP,32816,GANDRUNGMANGU,0,0,0
32676,JAWA TENGAH,32677,CILACAP,83525,JERUKLEGI,0,0,0
32676,JAWA TENGAH,32677,CILACAP,83535,KAMPUNG LAUT,0,0,0
32676,JAWA TENGAH,32677,CILACAP,32842,KARANGPUCUNG,0,0,0
32676,JAWA TENGAH,32677,CILACAP,32803,KAWUNGANTEN,0,0,0
32676,JAWA TENGAH,32677,CILACAP,83522,KEDUNGREJA,0,0,0
32676,JAWA TENGAH,32677,CILACAP,32690,KESUGIHAN,0,0,0
32676,JAWA TENGAH,32677,CILACAP,83523,KROYA,0,0,0
32676,JAWA TENGAH,32677,CILACAP,32873,MAJENANG,0,0,0
32676,JAWA TENGAH,32677,CILACAP,83524,MAOS,0,0,0
32676,JAWA TENGAH,32677,CILACAP,32742,NUSAWUNGU,0,0,0
32676,JAWA TENGAH,32677,CILACAP,83530,PATIMUAN,0,0,0
32676,JAWA TENGAH,32677,CILACAP,83528,SAMPANG,0,0,0
32676,JAWA TENGAH,32677,CILACAP,32831,SIDAREJA,0,0,0
32676,JAWA TENGAH,32677,CILACAP,83526,WANAREJA,0,0,0
32676,JAWA TENGAH,38917,DEMAK,39123,BONANG,17262,31864,49126
32676,JAWA TENGAH,38917,DEMAK,39103,DEMAK,23527,34470,57997
32676,JAWA TENGAH,38917,DEMAK,39033,DEMPET,11194,18571,29765
32676,JAWA TENGAH,38917,DEMAK,39050,GAJAH,10882,15342,26224
32676,JAWA TENGAH,38917,DEMAK,38951,GUNTUR,16180,25048,41228
32676,JAWA TENGAH,38917,DEMAK,39069,KARANGANYAR,12057,24775,36832
32676,JAWA TENGAH,38917,DEMAK,38938,KARANGAWEN,21766,28299,50065
32676,JAWA TENGAH,38917,DEMAK,38993,KARANGTENGAH,11281,21573,32854
32676,JAWA TENGAH,38917,DEMAK,39166,KEBONAGUNG,7504,13234,20738
32676,JAWA TENGAH,38917,DEMAK,39087,MIJEN,7974,19891,27865
32676,JAWA TENGAH,38917,DEMAK,38918,MRANGGEN,33483,53744,87227
32676,JAWA TENGAH,38917,DEMAK,38972,SAYUNG,23464,32286,55750
32676,JAWA TENGAH,38917,DEMAK,39145,WEDUNG,13575,23916,37491
32676,JAWA TENGAH,38917,DEMAK,39011,WONOSALAM,13927,26713,40640
32676,JAWA TENGAH,37214,GROBOGAN,37414,BRATI,6648,18786,25434
32676,JAWA TENGAH,37214,GROBOGAN,37329,GABUS,7148,31642,38790
32676,JAWA TENGAH,37214,GROBOGAN,37286,GEYER,7805,28142,35947
32676,JAWA TENGAH,37214,GROBOGAN,37434,GODONG,13901,28913,42814
32676,JAWA TENGAH,37214,GROBOGAN,37383,GROBOGAN,0,0,0
32676,JAWA TENGAH,37214,GROBOGAN,37463,GUBUG,14325,26451,40776
32676,JAWA TENGAH,37214,GROBOGAN,37228,KARANGRAYUNG,9705,36188,45893
32676,JAWA TENGAH,37214,GROBOGAN,37215,KEDUNGJATI,7492,14829,22321
32676,JAWA TENGAH,37214,GROBOGAN,37424,KLAMBU,5873,13065,18938
32676,JAWA TENGAH,37214,GROBOGAN,37314,KRADENAN,0,0,0
32676,JAWA TENGAH,37214,GROBOGAN,37344,NGARINGAN,9803,26044,35847
32676,JAWA TENGAH,37214,GROBOGAN,37248,PENAWANGAN,0,0,0
32676,JAWA TENGAH,37214,GROBOGAN,37300,PULOKULON,11612,42594,54206
32676,JAWA TENGAH,37214,GROBOGAN,37396,PURWODADI,21586,50862,72448
32676,JAWA TENGAH,37214,GROBOGAN,37504,TANGGUNGHARJO,5959,15222,21181
32676,JAWA TENGAH,37214,GROBOGAN,37372,TAWANGHARJO,6580,20819,27399
32676,JAWA TENGAH,37214,GROBOGAN,37485,TEGOWANU,0,0,0
32676,JAWA TENGAH,37214,GROBOGAN,37269,TOROH,13613,45775,59388
32676,JAWA TENGAH,37214,GROBOGAN,37357,WIROSARI,12161,36063,48224
32676,JAWA TENGAH,38706,JEPARA,38812,BANGSRI,12216,39188,51404
32676,JAWA TENGAH,38706,JEPARA,38774,BATEALIT,14389,29415,43804
32676,JAWA TENGAH,38706,JEPARA,38899,DONOROJO,8575,23119,31694
32676,JAWA TENGAH,38706,JEPARA,38786,JEPARA,12818,31196,44014
32676,JAWA TENGAH,38706,JEPARA,38874,KALINYAMATAN,13022,19165,32187
32676,JAWA TENGAH,38706,JEPARA,38838,KARIMUN JAWA,988,3728,4716
32676,JAWA TENGAH,38706,JEPARA,38707,KEDUNG,11714,25211,36925
32676,JAWA TENGAH,38706,JEPARA,38825,KELING,8011,27254,35265
32676,JAWA TENGAH,38706,JEPARA,38887,KEMBANG,9721,29304,39025
32676,JAWA TENGAH,38706,JEPARA,38755,MAYONG,15329,31047,46376
32676,JAWA TENGAH,38706,JEPARA,38803,MLONGGO,12133,30670,42803
32676,JAWA TENGAH,38706,JEPARA,38858,NALUMSARI,11362,23815,35177
32676,JAWA TENGAH,38706,JEPARA,38908,PAKIS AJI,8124,22394,30518
32676,JAWA TENGAH,38706,JEPARA,38726,PECANGAAN,15351,28816,44167
32676,JAWA TENGAH,38706,JEPARA,38842,TAHUNAN,13514,44946,58460
32676,JAWA TENGAH,38706,JEPARA,38739,WELAHAN,13474,27142,40616
32676,JAWA TENGAH,36790,KARANGANYAR,36913,COLOMADU,9659,29553,39212
32676,JAWA TENGAH,36790,KARANGANYAR,36925,GONDANGREJO,9237,37052,46289
32676,JAWA TENGAH,36790,KARANGANYAR,36904,JATEN,14067,35499,49566
32676,JAWA TENGAH,36790,KARANGANYAR,36791,JATIPURO,5041,15091,20132
32676,JAWA TENGAH,36790,KARANGANYAR,36802,JATIYOSO,5870,18143,24013
32676,JAWA TENGAH,36790,KARANGANYAR,36975,JENAWI,4628,11445,16073
32676,JAWA TENGAH,36790,KARANGANYAR,36825,JUMANTONO,7001,20883,27884
32676,JAWA TENGAH,36790,KARANGANYAR,36812,JUMAPOLO,5192,18740,23932
32676,JAWA TENGAH,36790,KARANGANYAR,36880,KARANGANYAR,15636,33038,48674
32676,JAWA TENGAH,36790,KARANGANYAR,36868,KARANGPANDAN,6132,19212,25344
32676,JAWA TENGAH,36790,KARANGANYAR,36939,KEBAKKRAMAT,11593,27950,39543
32676,JAWA TENGAH,36790,KARANGANYAR,36964,KERJO,5938,15807,21745
32676,JAWA TENGAH,36790,KARANGANYAR,36837,MATESIH,8547,17353,25900
32676,JAWA TENGAH,36790,KARANGANYAR,36950,MOJOGEDANG,10628,28389,39017
32676,JAWA TENGAH,36790,KARANGANYAR,36858,NGARGOYOSO,5936,15203,21139
32676,JAWA TENGAH,36790,KARANGANYAR,36893,TASIKMADU,12679,24697,37376
32676,JAWA TENGAH,36790,KARANGANYAR,36847,TAWANGMANGU,7771,19101,26872
32676,JAWA TENGAH,33902,KEBUMEN,34209,ADIMULYO,9066,11729,20795
32676,JAWA TENGAH,33902,KEBUMEN,34126,ALIAN,11453,17734,29187
32676,JAWA TENGAH,33902,KEBUMEN,34036,AMBAL,12297,20296,32593
32676,JAWA TENGAH,33902,KEBUMEN,33903,AYAH,10641,23694,34335
32676,JAWA TENGAH,33902,KEBUMEN,34340,BONOROWO,5504,5349,10853
32676,JAWA TENGAH,33902,KEBUMEN,33922,BUAYAN,8410,22801,31211
32676,JAWA TENGAH,33902,KEBUMEN,34014,BULUSPESANTREN,13136,17686,30822
32676,JAWA TENGAH,33902,KEBUMEN,34285,GOMBONG,12332,15076,27408
32676,JAWA TENGAH,33902,KEBUMEN,34300,KARANGANYAR,7625,11814,19439
32676,JAWA TENGAH,33902,KEBUMEN,34312,KARANGGAYAM,6107,20798,26905
32676,JAWA TENGAH,33902,KEBUMEN,34374,KARANGSAMBUNG,6506,13853,20359
32676,JAWA TENGAH,33902,KEBUMEN,34143,KEBUMEN,30788,36174,66962
32676,JAWA TENGAH,33902,KEBUMEN,33989,KLIRONG,13143,20913,34056
32676,JAWA TENGAH,33902,KEBUMEN,34106,KUTOWINANGUN,11153,14001,25154
32676,JAWA TENGAH,33902,KEBUMEN,34233,KUWARASAN,10067,15930,25997
32676,JAWA TENGAH,33902,KEBUMEN,34069,MIRIT,10378,15578,25956
32676,JAWA TENGAH,33902,KEBUMEN,34352,PADURESO,3261,4863,8124
32676,JAWA TENGAH,33902,KEBUMEN,34173,PEJAGOAN,10655,16232,26887
32676,JAWA TENGAH,33902,KEBUMEN,33967,PETANAHAN,12904,19186,32090
32676,JAWA TENGAH,33902,KEBUMEN,34362,PONCOWARNO,3246,5397,8643
32676,JAWA TENGAH,33902,KEBUMEN,34092,PREMBUN,6738,8532,15270
32676,JAWA TENGAH,33902,KEBUMEN,33943,PURING,10742,20932,31674
32676,JAWA TENGAH,33902,KEBUMEN,34256,ROWOKELE,8509,15511,24020
32676,JAWA TENGAH,33902,KEBUMEN,34332,SADANG,2220,6951,9171
32676,JAWA TENGAH,33902,KEBUMEN,34268,SEMPOR,10001,22363,32364
32676,JAWA TENGAH,33902,KEBUMEN,34187,SRUWENG,10424,19320,29744
32676,JAWA TENGAH,39746,KENDAL,39840,BOJA,20544,22772,43316
32676,JAWA TENGAH,39746,KENDAL,39869,BRANGSONG,11991,15921,27912
32676,JAWA TENGAH,39746,KENDAL,39929,CEPIRING,12680,16947,29627
32676,JAWA TENGAH,39746,KENDAL,39895,GEMUH,9810,18419,28229
32676,JAWA TENGAH,39746,KENDAL,39859,KALIWUNGU,17245,18495,35740
32676,JAWA TENGAH,39746,KENDAL,40044,KALIWUNGU SELATAN,11478,15649,27127
32676,JAWA TENGAH,39746,KENDAL,40002,KANGKUNG,9276,17177,26453
32676,JAWA TENGAH,39746,KENDAL,39964,KENDAL,16157,16732,32889
32676,JAWA TENGAH,39746,KENDAL,39823,LIMBANGAN,10447,10122,20569
32676,JAWA TENGAH,39746,KENDAL,40031,NGAMPEL,7251,11861,19112
32676,JAWA TENGAH,39746,KENDAL,39760,PAGERUYUNG,7826,12020,19846
32676,JAWA TENGAH,39746,KENDAL,39794,PATEAN,10922,18843,29765
32676,JAWA TENGAH,39746,KENDAL,39945,PATEBON,14226,19499,33725
32676,JAWA TENGAH,39746,KENDAL,39882,PEGANDON,8490,12393,20883
32676,JAWA TENGAH,39746,KENDAL,39747,PLANTUNGAN,6437,9941,16378
32676,JAWA TENGAH,39746,KENDAL,40018,RINGINARUM,6427,13844,20271
32676,JAWA TENGAH,39746,KENDAL,39985,ROWOSARI,9254,19098,28352
32676,JAWA TENGAH,39746,KENDAL,39809,SINGOROJO,11692,17006,28698
32676,JAWA TENGAH,39746,KENDAL,39775,SUKOREJO,13853,20273,34126
32676,JAWA TENGAH,39746,KENDAL,39912,WELERI,12702,22469,35171
32676,JAWA TENGAH,35862,KLATEN,35917,BAYAT,6099,29007,35106
32676,JAWA TENGAH,35862,KLATEN,35936,CAWAS,6257,28114,34371
32676,JAWA TENGAH,35862,KLATEN,36035,CEPER,9106,29853,38959
32676,JAWA TENGAH,35862,KLATEN,36128,DELANGGU,7808,18067,25875
32676,JAWA TENGAH,35862,KLATEN,35880,GANTIWARNO,5769,17131,22900
32676,JAWA TENGAH,35862,KLATEN,36203,JATINOM,10251,24032,34283
32676,JAWA TENGAH,35862,KLATEN,35984,JOGONALAN,7895,26771,34666
32676,JAWA TENGAH,35862,KLATEN,36089,JUWIRING,8739,26529,35268
32676,JAWA TENGAH,35862,KLATEN,36250,KALIKOTES,4765,15657,20422
32676,JAWA TENGAH,35862,KLATEN,36164,KARANGANOM,8006,19403,27409
32676,JAWA TENGAH,35862,KLATEN,36069,KARANGDOWO,6134,20527,26661
32676,JAWA TENGAH,35862,KLATEN,36020,KARANGNONGKO,5401,16492,21893
32676,JAWA TENGAH,35862,KLATEN,35976,KEBONARUM,3429,8561,11990
32676,JAWA TENGAH,35862,KLATEN,36222,KEMALANG,4732,17473,22205
32676,JAWA TENGAH,35862,KLATEN,36277,KLATEN SELATAN,7312,18090,25402
32676,JAWA TENGAH,35862,KLATEN,36267,KLATEN TENGAH,6523,18523,25046
32676,JAWA TENGAH,35862,KLATEN,36258,KLATEN UTARA,8653,19462,28115
32676,JAWA TENGAH,35862,KLATEN,36003,MANISRENGGO,6896,19169,26065
32676,JAWA TENGAH,35862,KLATEN,36236,NGAWEN,9630,17000,26630
32676,JAWA TENGAH,35862,KLATEN,36054,PEDAN,5420,23192,28612
32676,JAWA TENGAH,35862,KLATEN,36145,POLANHARJO,6885,17727,24612
32676,JAWA TENGAH,35862,KLATEN,35863,PRAMBANAN,9270,21236,30506
32676,JAWA TENGAH,35862,KLATEN,35957,TRUCUK,10171,35820,45991
32676,JAWA TENGAH,35862,KLATEN,36184,TULUNG,8231,22597,30828
32676,JAWA TENGAH,35862,KLATEN,35897,WEDI,7174,22879,30053
32676,JAWA TENGAH,35862,KLATEN,36109,WONOSARI,8479,29319,37798
32676,JAWA TENGAH,41480,KOTA MAGELANG,41481,MAGELANG SELATAN,10589,13871,24460
32676,JAWA TENGAH,41480,KOTA MAGELANG,41494,MAGELANG TENGAH,10687,17662,28349
32676,JAWA TENGAH,41480,KOTA MAGELANG,41488,MAGELANG UTARA,10897,10523,21420
32676,JAWA TENGAH,41779,KOTA PEKALONGAN,41780,PEKALONGAN BARAT,20534,31442,51976
32676,JAWA TENGAH,41779,KOTA PEKALONGAN,41819,PEKALONGAN SELATAN,11589,20383,31972
32676,JAWA TENGAH,41779,KOTA PEKALONGAN,41794,PEKALONGAN TIMUR,15273,21727,37000
32676,JAWA TENGAH,41779,KOTA PEKALONGAN,41808,PEKALONGAN UTARA,17342,26262,43604
32676,JAWA TENGAH,41558,KOTA SALATIGA,41573,ARGOMULYO,9905,16292,26197
32676,JAWA TENGAH,41558,KOTA SALATIGA,41580,SIDOMUKTI,9218,15535,24753
32676,JAWA TENGAH,41558,KOTA SALATIGA,41559,SIDOREJO,10885,19723,30608
32676,JAWA TENGAH,41558,KOTA SALATIGA,41566,TINGKIR,8620,17114,25734
32676,JAWA TENGAH,41585,KOTA SEMARANG,41699,BANYUMANIK,28471,49308,77779
32676,JAWA TENGAH,41585,KOTA SEMARANG,41669,CANDISARI,13810,33069,46879
32676,JAWA TENGAH,41585,KOTA SEMARANG,41677,GAJAH MUNGKUR,11294,23001,34295
32676,JAWA TENGAH,41585,KOTA SEMARANG,41623,GAYAM SARI,11293,29708,41001
32676,JAWA TENGAH,41585,KOTA SEMARANG,41631,GENUK,18179,37678,55857
32676,JAWA TENGAH,41585,KOTA SEMARANG,41711,GUNUNGPATI,20928,29560,50488
32676,JAWA TENGAH,41585,KOTA SEMARANG,41745,MIJEN,15573,19602,35175
32676,JAWA TENGAH,41585,KOTA SEMARANG,41760,NGALIYAN,31692,45356,77048
32676,JAWA TENGAH,41585,KOTA SEMARANG,41645,PEDURUNGAN,33160,71319,104479
32676,JAWA TENGAH,41585,KOTA SEMARANG,41728,SEMARANG BARAT,25016,65319,90335
32676,JAWA TENGAH,41585,KOTA SEMARANG,41658,SEMARANG SELATAN,12467,29157,41624
32676,JAWA TENGAH,41585,KOTA SEMARANG,41586,SEMARANG TENGAH,7745,29858,37603
32676,JAWA TENGAH,41585,KOTA SEMARANG,41612,SEMARANG TIMUR,9049,34399,43448
32676,JAWA TENGAH,41585,KOTA SEMARANG,41602,SEMARANG UTARA,16759,53375,70134
32676,JAWA TENGAH,41585,KOTA SEMARANG,41686,TEMBALANG,28756,63864,92620
32676,JAWA TENGAH,41585,KOTA SEMARANG,41771,TUGU,8304,9716,18020
32676,JAWA TENGAH,41501,KOTA SURAKARTA,41544,BANJARSARI,15354,90761,106115
32676,JAWA TENGAH,41501,KOTA SURAKARTA,41532,JEBRES,11173,77733,88906
32676,JAWA TENGAH,41501,KOTA SURAKARTA,41502,LAWEYAN,11424,47610,59034
32676,JAWA TENGAH,41501,KOTA SURAKARTA,41522,PASAR KLIWON,9992,40553,50545
32676,JAWA TENGAH,41501,KOTA SURAKARTA,41514,SERENGAN,4760,27542,32302
32676,JAWA TENGAH,41831,KOTA TEGAL,41855,MARGADANA,8131,13944,22075
32676,JAWA TENGAH,41831,KOTA TEGAL,41832,TEGAL BARAT,13286,22593,35879
32676,JAWA TENGAH,41831,KOTA TEGAL,41846,TEGAL SELATAN,14964,18810,33774
32676,JAWA TENGAH,41831,KOTA TEGAL,41840,TEGAL TIMUR,19531,23428,42959
32676,JAWA TENGAH,38564,KUDUS,38664,BAE,18224,20862,39086
32676,JAWA TENGAH,38564,KUDUS,38687,DAWE,19856,35716,55572
32676,JAWA TENGAH,38564,KUDUS,38675,GEBOG,20288,30483,50771
32676,JAWA TENGAH,38564,KUDUS,38607,JATI,26868,33698,60566
32676,JAWA TENGAH,38564,KUDUS,38651,JEKULO,28108,31031,59139
32676,JAWA TENGAH,38564,KUDUS,38565,KALIWUNGU,23864,27994,51858
32676,JAWA TENGAH,38564,KUDUS,38581,KUDUS,22734,31777,54511
32676,JAWA TENGAH,38564,KUDUS,38639,MEJOBO,18295,24893,43188
32676,JAWA TENGAH,38564,KUDUS,38622,UNDAAN,16934,23930,40864
32676,JAWA TENGAH,35181,MAGELANG,35409,BANDONGAN,17942,15428,33370
32676,JAWA TENGAH,35181,MAGELANG,35203,BOROBUDUR,15105,21472,36577
32676,JAWA TENGAH,35181,MAGELANG,35424,CANDIMULYO,11691,17803,29494
32676,JAWA TENGAH,35181,MAGELANG,35264,DUKUN,14303,14673,28976
32676,JAWA TENGAH,35181,MAGELANG,35482,GRABAG,19900,32681,52581
32676,JAWA TENGAH,35181,MAGELANG,35358,KAJORAN,13389,18419,31808
32676,JAWA TENGAH,35181,MAGELANG,35388,KALIANGKRIK,15494,15799,31293
32676,JAWA TENGAH,35181,MAGELANG,35328,MERTOYUDAN,33186,30995,64181
32676,JAWA TENGAH,35181,MAGELANG,35311,MUNGKID,24554,19692,44246
32676,JAWA TENGAH,35181,MAGELANG,35296,MUNTILAN,22031,26459,48490
32676,JAWA TENGAH,35181,MAGELANG,35465,NGABLAK,9563,17025,26588
32676,JAWA TENGAH,35181,MAGELANG,35224,NGLUWAR,9337,10753,20090
32676,JAWA TENGAH,35181,MAGELANG,35444,PAKIS,12748,22325,35073
32676,JAWA TENGAH,35181,MAGELANG,35233,SALAM,13752,14992,28744
32676,JAWA TENGAH,35181,MAGELANG,35182,SALAMAN,17373,23159,40532
32676,JAWA TENGAH,35181,MAGELANG,35280,SAWANGAN,17488,18322,35810
32676,JAWA TENGAH,35181,MAGELANG,35533,SECANG,20741,24914,45655
32676,JAWA TENGAH,35181,MAGELANG,35246,SRUMBUNG,16696,13113,29809
32676,JAWA TENGAH,35181,MAGELANG,35511,TEGALREJO,13883,18847,32730
32676,JAWA TENGAH,35181,MAGELANG,35342,TEMPURAN,12774,15842,28616
32676,JAWA TENGAH,35181,MAGELANG,35554,WINDUSARI,13455,14745,28200
32676,JAWA TENGAH,38136,PATI,38265,BATANGAN,0,0,0
32676,JAWA TENGAH,38136,PATI,38498,CLUWAK,0,0,0
32676,JAWA TENGAH,38136,PATI,38534,DUKUHSETI,0,0,0
32676,JAWA TENGAH,38136,PATI,38368,GABUS,0,0,0
32676,JAWA TENGAH,38136,PATI,38412,GEMBONG,0,0,0
32676,JAWA TENGAH,38136,PATI,38482,GUNUNGWUNGKAL,0,0,0
32676,JAWA TENGAH,38136,PATI,38243,JAKEN,0,0,0
32676,JAWA TENGAH,38136,PATI,38314,JAKENAN,0,0,0
32676,JAWA TENGAH,38136,PATI,38284,JUWANA,0,0,0
32676,JAWA TENGAH,38136,PATI,38154,KAYEN,0,0,0
32676,JAWA TENGAH,38136,PATI,38393,MARGOREJO,0,0,0
32676,JAWA TENGAH,38136,PATI,38459,MARGOYOSO,0,0,0
32676,JAWA TENGAH,38136,PATI,38338,PATI,0,0,0
32676,JAWA TENGAH,38136,PATI,38222,PUCAKWANGI,0,0,0
32676,JAWA TENGAH,38136,PATI,38137,SUKOLILO,0,0,0
32676,JAWA TENGAH,38136,PATI,38172,TAMBAKROMO,0,0,0
32676,JAWA TENGAH,38136,PATI,38512,TAYU,0,0,0
32676,JAWA TENGAH,38136,PATI,38424,TLOGOWUNGU,0,0,0
32676,JAWA TENGAH,38136,PATI,38547,TRANGKIL,0,0,0
32676,JAWA TENGAH,38136,PATI,38440,WEDARIJAKSA,0,0,0
32676,JAWA TENGAH,38136,PATI,38191,WINONG,0,0,0
32676,JAWA TENGAH,40317,PEKALONGAN,40481,BOJONG,9744,26604,36348
32676,JAWA TENGAH,40317,PEKALONGAN,40539,BUARAN,8427,16765,25192
32676,JAWA TENGAH,40317,PEKALONGAN,40382,DORO,6561,15336,21897
32676,JAWA TENGAH,40317,PEKALONGAN,40413,KAJEN,13019,20409,33428
32676,JAWA TENGAH,40317,PEKALONGAN,40318,KANDANGSERANG,5388,11494,16882
32676,JAWA TENGAH,40317,PEKALONGAN,40397,KARANGANYAR,7534,13819,21353
32676,JAWA TENGAH,40317,PEKALONGAN,40598,KARANGDADAP,5066,14802,19868
32676,JAWA TENGAH,40317,PEKALONGAN,40519,KEDUNGWUNI,18124,34767,52891
32676,JAWA TENGAH,40317,PEKALONGAN,40439,KESESI,11207,22725,33932
32676,JAWA TENGAH,40317,PEKALONGAN,40349,LEBAKBARANG,1516,4156,5672
32676,JAWA TENGAH,40317,PEKALONGAN,40333,PANINGGARAN,6528,11584,18112
32676,JAWA TENGAH,40317,PEKALONGAN,40361,PETUNGKRIYONO,2105,4886,6991
32676,JAWA TENGAH,40317,PEKALONGAN,40584,SIWALAN,5028,15551,20579
32676,JAWA TENGAH,40317,PEKALONGAN,40463,SRAGI,9207,23629,32836
32676,JAWA TENGAH,40317,PEKALONGAN,40371,TALUN,4520,10028,14548
32676,JAWA TENGAH,40317,PEKALONGAN,40550,TIRTO,10309,27694,38003
32676,JAWA TENGAH,40317,PEKALONGAN,40567,WIRADESA,11949,20788,32737
32676,JAWA TENGAH,40317,PEKALONGAN,40610,WONOKERTO,5019,17005,22024
32676,JAWA TENGAH,40317,PEKALONGAN,40504,WONOPRINGGO,7341,16203,23544
32676,JAWA TENGAH,40622,PEMALANG,40797,AMPELGADING,10478,24394,34872
32676,JAWA TENGAH,40622,PEMALANG,40696,BANTARBOLANG,11943,25472,37415
32676,JAWA TENGAH,40622,PEMALANG,40647,BELIK,15217,36218,51435
32676,JAWA TENGAH,40622,PEMALANG,40676,BODEH,9093,20539,29632
32676,JAWA TENGAH,40622,PEMALANG,40814,COMAL,14910,33516,48426
32676,JAWA TENGAH,40622,PEMALANG,40623,MOGA,16932,13775,30707
32676,JAWA TENGAH,40622,PEMALANG,40733,PEMALANG,36843,61976,98819
32676,JAWA TENGAH,40622,PEMALANG,40776,PETARUKAN,24473,54920,79393
32676,JAWA TENGAH,40622,PEMALANG,40634,PULOSARI,13131,15417,28548
32676,JAWA TENGAH,40622,PEMALANG,40714,RANDUDONGKAL,20286,30936,51222
32676,JAWA TENGAH,40622,PEMALANG,40754,TAMAN,30608,55755,86363
32676,JAWA TENGAH,40622,PEMALANG,40833,ULUJAMI,14131,42849,56980
32676,JAWA TENGAH,40622,PEMALANG,40852,WARUNGPRING,5630,12705,18335
32676,JAWA TENGAH,40622,PEMALANG,40660,WATUKUMPUL,9018,24996,34014
32676,JAWA TENGAH,33345,PURBALINGGA,33481,BOBOTSARI,12439,15550,27989
32676,JAWA TENGAH,33345,PURBALINGGA,33545,BOJONGSARI,12041,20961,33002
32676,JAWA TENGAH,33345,PURBALINGGA,33366,BUKATEJA,14990,24535,39525
32676,JAWA TENGAH,33345,PURBALINGGA,33395,KALIGONDANG,12111,22273,34384
32676,JAWA TENGAH,33345,PURBALINGGA,33428,KALIMANAH,12142,19189,31331
32676,JAWA TENGAH,33345,PURBALINGGA,33506,KARANGANYAR,6964,11818,18782
32676,JAWA TENGAH,33345,PURBALINGGA,33584,KARANGJAMBU,3463,9131,12594
32676,JAWA TENGAH,33345,PURBALINGGA,33520,KARANGMONCOL,9902,17958,27860
32676,JAWA TENGAH,33345,PURBALINGGA,33498,KARANGREJA,7491,14615,22106
32676,JAWA TENGAH,33345,PURBALINGGA,33381,KEJOBONG,7690,17272,24962
32676,JAWA TENGAH,33345,PURBALINGGA,33346,KEMANGKON,13931,19774,33705
32676,JAWA TENGAH,33345,PURBALINGGA,33591,KERTANEGARA,6272,10380,16652
32676,JAWA TENGAH,33345,PURBALINGGA,33446,KUTASARI,11227,21440,32667
32676,JAWA TENGAH,33345,PURBALINGGA,33461,MREBET,13984,24042,38026
32676,JAWA TENGAH,33345,PURBALINGGA,33559,PADAMARA,9478,14890,24368
32676,JAWA TENGAH,33345,PURBALINGGA,33574,PENGADEGAN,5974,14530,20504
32676,JAWA TENGAH,33345,PURBALINGGA,33414,PURBALINGGA,15054,18887,33941
32676,JAWA TENGAH,33345,PURBALINGGA,33532,REMBANG,8720,23459,32179
32676,JAWA TENGAH,34389,PURWOREJO,34522,BAGELEN,6328,11504,17832
32676,JAWA TENGAH,34389,PURWOREJO,34588,BANYU URIP,11057,13138,24195
32676,JAWA TENGAH,34389,PURWOREJO,34616,BAYAN,12064,15807,27871
32676,JAWA TENGAH,34389,PURWOREJO,34871,BENER,9630,21076,30706
32676,JAWA TENGAH,34389,PURWOREJO,34804,BRUNO,8499,15908,24407
32676,JAWA TENGAH,34389,PURWOREJO,34671,BUTUH,11133,13463,24596
32676,JAWA TENGAH,34389,PURWOREJO,34823,GEBANG,8798,14459,23257
32676,JAWA TENGAH,34389,PURWOREJO,34390,GRABAG,10894,16055,26949
32676,JAWA TENGAH,34389,PURWOREJO,34540,KALIGESING,6164,12561,18725
32676,JAWA TENGAH,34389,PURWOREJO,34763,KEMIRI,12240,20532,32772
32676,JAWA TENGAH,34389,PURWOREJO,34643,KUTOARJO,12953,22397,35350
32676,JAWA TENGAH,34389,PURWOREJO,34849,LOANO,7521,13671,21192
32676,JAWA TENGAH,34389,PURWOREJO,34423,NGOMBOL,9261,10759,20020
32676,JAWA TENGAH,34389,PURWOREJO,34713,PITURUH,11661,17261,28922
32676,JAWA TENGAH,34389,PURWOREJO,34481,PURWODADI,9433,13627,23060
32676,JAWA TENGAH,34389,PURWOREJO,34562,PURWOREJO,18554,30028,48582
32676,JAWA TENGAH,37826,REMBANG,37846,BULU,4549,12279,16828
32676,JAWA TENGAH,37826,REMBANG,37863,GUNEM,4882,9641,14523
32676,JAWA TENGAH,37826,REMBANG,37988,KALIORI,5943,19617,25560
32676,JAWA TENGAH,37826,REMBANG,38072,KRAGAN,10997,27224,38221
32676,JAWA TENGAH,37826,REMBANG,38115,LASEM,9135,18839,27974
32676,JAWA TENGAH,37826,REMBANG,37942,PAMOTAN,10768,16246,27014
32676,JAWA TENGAH,37826,REMBANG,38048,PANCUR,6739,10696,17435
32676,JAWA TENGAH,37826,REMBANG,38012,REMBANG,16407,36968,53375
32676,JAWA TENGAH,37826,REMBANG,37880,SALE,7307,14943,22250
32676,JAWA TENGAH,37826,REMBANG,37896,SARANG,18747,18177,36924
32676,JAWA TENGAH,37826,REMBANG,37920,SEDAN,14521,15279,29800
32676,JAWA TENGAH,37826,REMBANG,38100,SLUKE,4362,11608,15970
32676,JAWA TENGAH,37826,REMBANG,37966,SULANG,6463,17008,23471
32676,JAWA TENGAH,37826,REMBANG,37827,SUMBER,5634,16868,22502
32676,JAWA TENGAH,39181,SEMARANG,39318,AMBARAWA,11319,26255,37574
32676,JAWA TENGAH,39181,SEMARANG,39380,BANCAK,0,0,0
32676,JAWA TENGAH,39181,SEMARANG,39425,BANDUNGAN,13504,20685,34189
32676,JAWA TENGAH,39181,SEMARANG,39279,BANYUBIRU,10196,15343,25539
32676,JAWA TENGAH,39181,SEMARANG,39329,BAWEN,12609,20824,33433
32676,JAWA TENGAH,39181,SEMARANG,39356,BERGAS,17081,22598,39679
32676,JAWA TENGAH,39181,SEMARANG,39339,BRINGIN,10165,15684,25849
32676,JAWA TENGAH,39181,SEMARANG,39182,GETASAN,10042,22729,32771
32676,JAWA TENGAH,39181,SEMARANG,39290,JAMBU,9185,15169,24354
32676,JAWA TENGAH,39181,SEMARANG,39390,KALIWUNGU,4651,13254,17905
32676,JAWA TENGAH,39181,SEMARANG,39244,PABELAN,9308,15980,25288
32676,JAWA TENGAH,39181,SEMARANG,39370,PRINGAPUS,11579,17931,29510
32676,JAWA TENGAH,39181,SEMARANG,39301,SUMOWONO,8657,10658,19315
32676,JAWA TENGAH,39181,SEMARANG,39226,SURUH,15181,22460,37641
32676,JAWA TENGAH,39181,SEMARANG,39212,SUSUKAN,10269,16543,26812
32676,JAWA TENGAH,39181,SEMARANG,39196,TENGARAN,16397,24177,40574
32676,JAWA TENGAH,39181,SEMARANG,39262,TUNTANG,14732,24114,38846
32676,JAWA TENGAH,39181,SEMARANG,39402,UNGARAN BARAT,0,0,0
32676,JAWA TENGAH,39181,SEMARANG,39414,UNGARAN TIMUR,18054,22367,40421
32676,JAWA TENGAH,36985,SRAGEN,37132,GEMOLONG,7463,21287,28750
32676,JAWA TENGAH,36985,SRAGEN,37190,GESI,2482,10120,12602
32676,JAWA TENGAH,36985,SRAGEN,37053,GONDANG,6765,19745,26510
32676,JAWA TENGAH,36985,SRAGEN,37206,JENAR,3148,13503,16651
32676,JAWA TENGAH,36985,SRAGEN,36986,KALIJAMBE,6955,21888,28843
32676,JAWA TENGAH,36985,SRAGEN,37082,KARANGMALANG,11753,27460,39213
32676,JAWA TENGAH,36985,SRAGEN,37032,KEDAWUNG,8015,28446,36461
32676,JAWA TENGAH,36985,SRAGEN,37018,MASARAN,12587,31576,44163
32676,JAWA TENGAH,36985,SRAGEN,37147,MIRI,4092,16251,20343
32676,JAWA TENGAH,36985,SRAGEN,37170,MONDOKAN,3017,16991,20008
32676,JAWA TENGAH,36985,SRAGEN,37073,NGRAMPAL,5900,18235,24135
32676,JAWA TENGAH,36985,SRAGEN,37001,PLUPUH,5491,23320,28811
32676,JAWA TENGAH,36985,SRAGEN,37043,SAMBIREJO,4598,16842,21440
32676,JAWA TENGAH,36985,SRAGEN,37063,SAMBUNGMACAN,6830,21354,28184
32676,JAWA TENGAH,36985,SRAGEN,37102,SIDOHARJO,8627,24429,33056
32676,JAWA TENGAH,36985,SRAGEN,37093,SRAGEN,11832,29784,41616
32676,JAWA TENGAH,36985,SRAGEN,37180,SUKODONO,4950,13747,18697
32676,JAWA TENGAH,36985,SRAGEN,37158,SUMBERLAWANG,5418,22456,27874
32676,JAWA TENGAH,36985,SRAGEN,37198,TANGEN,3721,12285,16006
32676,JAWA TENGAH,36985,SRAGEN,37115,TANON,7401,24706,32107
32676,JAWA TENGAH,36290,SUKOHARJO,36427,BAKI,7721,34193,41914
32676,JAWA TENGAH,36290,SUKOHARJO,36363,BENDOSARI,6937,28495,35432
32676,JAWA TENGAH,36290,SUKOHARJO,36305,BULU,3086,17874,20960
32676,JAWA TENGAH,36290,SUKOHARJO,36442,GATAK,6873,24498,31371
32676,JAWA TENGAH,36290,SUKOHARJO,36412,GROGOL,13250,58599,71849
32676,JAWA TENGAH,36290,SUKOHARJO,36457,KARTASURA,16335,46712,63047
32676,JAWA TENGAH,36290,SUKOHARJO,36396,MOJOLABAN,11426,43611,55037
32676,JAWA TENGAH,36290,SUKOHARJO,36346,NGUTER,6397,24346,30743
32676,JAWA TENGAH,36290,SUKOHARJO,36378,POLOKARTO,9654,39609,49263
32676,JAWA TENGAH,36290,SUKOHARJO,36331,SUKOHARJO,11529,43070,54599
32676,JAWA TENGAH,36290,SUKOHARJO,36318,TAWANGSARI,5419,25354,30773
32676,JAWA TENGAH,36290,SUKOHARJO,36291,WERU,7190,25137,32327
32676,JAWA TENGAH,40859,TEGAL,41026,ADIWERNA,25109,40877,65986
32676,JAWA TENGAH,40859,TEGAL,40911,BALAPULANG,17672,23726,41398
32676,JAWA TENGAH,40859,TEGAL,40893,BOJONG,15625,17585,33210
32676,JAWA TENGAH,40859,TEGAL,40874,BUMIJAWA,20600,21796,42396
32676,JAWA TENGAH,40859,TEGAL,41068,DUKUHTURI,19389,26580,45969
32676,JAWA TENGAH,40859,TEGAL,41154,DUKUHWARU,10892,21175,32067
32676,JAWA TENGAH,40859,TEGAL,40962,JATINEGARA,11341,15294,26635
32676,JAWA TENGAH,40859,TEGAL,40980,KEDUNGBANTENG,8217,13124,21341
32676,JAWA TENGAH,40859,TEGAL,41108,KRAMAT,20621,37785,58406
32676,JAWA TENGAH,40859,TEGAL,40946,LEBAKSIU,15347,26150,41497
32676,JAWA TENGAH,40859,TEGAL,40860,MARGASARI,19655,29269,48924
32676,JAWA TENGAH,40859,TEGAL,40932,PAGERBARANG,8323,19173,27496
32676,JAWA TENGAH,40859,TEGAL,40991,PANGKAH,24861,31440,56301
32676,JAWA TENGAH,40859,TEGAL,41015,SLAWI,18385,22878,41263
32676,JAWA TENGAH,40859,TEGAL,41129,SURADADI,14611,28976,43587
32676,JAWA TENGAH,40859,TEGAL,41048,TALANG,21883,31342,53225
32676,JAWA TENGAH,40859,TEGAL,41087,TARUB,14990,24449,39439
32676,JAWA TENGAH,40859,TEGAL,41141,WARUREJA,10329,20342,30671
32676,JAWA TENGAH,39436,TEMANGGUNG,39678,BANSARI,2509,13190,15699
32676,JAWA TENGAH,39436,TEMANGGUNG,39706,BEJEN,4610,8161,12771
32676,JAWA TENGAH,39436,TEMANGGUNG,39437,BULU,10895,19248,30143
32676,JAWA TENGAH,39436,TEMANGGUNG,39623,CANDIROTO,6064,14113,20177
32676,JAWA TENGAH,39436,TEMANGGUNG,39735,GEMAWANG,7795,12372,20167
32676,JAWA TENGAH,39436,TEMANGGUNG,39597,JUMO,5997,12856,18853
32676,JAWA TENGAH,39436,TEMANGGUNG,39512,KALORAN,9958,17319,27277
32676,JAWA TENGAH,39436,TEMANGGUNG,39527,KANDANGAN,11985,18354,30339
32676,JAWA TENGAH,39436,TEMANGGUNG,39544,KEDU,14170,20595,34765
32676,JAWA TENGAH,39436,TEMANGGUNG,39692,KLEDUNG,4990,11960,16950
32676,JAWA TENGAH,39436,TEMANGGUNG,39638,KRANGGAN,10216,18722,28938
32676,JAWA TENGAH,39436,TEMANGGUNG,39576,NGADIREJO,8857,25266,34123
32676,JAWA TENGAH,39436,TEMANGGUNG,39559,PARAKAN,11289,20857,32146
32676,JAWA TENGAH,39436,TEMANGGUNG,39497,PRINGSURAT,11300,19903,31203
32676,JAWA TENGAH,39436,TEMANGGUNG,39665,SELOPAMPANG,5737,6112,11849
32676,JAWA TENGAH,39436,TEMANGGUNG,39471,TEMANGGUNG,20538,28791,49329
32676,JAWA TENGAH,39436,TEMANGGUNG,39457,TEMBARAK,6729,11013,17742
32676,JAWA TENGAH,39436,TEMANGGUNG,39652,TLOGOMULYO,3440,11397,14837
32676,JAWA TENGAH,39436,TEMANGGUNG,39611,TRETEP,3881,9132,13013
32676,JAWA TENGAH,39436,TEMANGGUNG,39721,WONOBOYO,6252,9757,16009
32676,JAWA TENGAH,36470,WONOGIRI,36551,BATURETNO,0,0,0
32676,JAWA TENGAH,36470,WONOGIRI,36515,BATUWARNO,0,0,0
32676,JAWA TENGAH,36470,WONOGIRI,36694,BULUKERTO,0,0,0
32676,JAWA TENGAH,36470,WONOGIRI,36565,EROMOKO,0,0,0
32676,JAWA TENGAH,36470,WONOGIRI,36753,GIRIMARTO,0,0,0
32676,JAWA TENGAH,36470,WONOGIRI,36490,GIRITONTRO,0,0,0
32676,JAWA TENGAH,36470,WONOGIRI,36498,GIRIWOYO,0,0,0
32676,JAWA TENGAH,36470,WONOGIRI,36741,JATIPURNO,0,0,0
32676,JAWA TENGAH,36470,WONOGIRI,36651,JATIROTO,0,0,0
32676,JAWA TENGAH,36470,WONOGIRI,36723,JATISRONO,0,0,0
32676,JAWA TENGAH,36470,WONOGIRI,36768,KARANGTENGAH,0,0,0
32676,JAWA TENGAH,36470,WONOGIRI,36667,KISMANTORO,0,0,0
32676,JAWA TENGAH,36470,WONOGIRI,36590,MANYARAN,0,0,0
32676,JAWA TENGAH,36470,WONOGIRI,36626,NGADIROJO,0,0,0
32676,JAWA TENGAH,36470,WONOGIRI,36539,NGUNTORONADI,0,0,0
32676,JAWA TENGAH,36470,WONOGIRI,36774,PARANGGUPITO,0,0,0
32676,JAWA TENGAH,36470,WONOGIRI,36471,PRACIMANTORO,0,0,0
32676,JAWA TENGAH,36470,WONOGIRI,36783,PUHPELEM,0,0,0
32676,JAWA TENGAH,36470,WONOGIRI,36678,PURWANTORO,0,0,0
32676,JAWA TENGAH,36470,WONOGIRI,36598,SELOGIRI,0,0,0
32676,JAWA TENGAH,36470,WONOGIRI,36638,SIDOARJO,0,0,0
32676,JAWA TENGAH,36470,WONOGIRI,36705,SLOGOHIMO,0,0,0
32676,JAWA TENGAH,36470,WONOGIRI,36524,TIRTOMOYO,0,0,0
32676,JAWA TENGAH,36470,WONOGIRI,36610,WONOGIRI,0,0,0
32676,JAWA TENGAH,36470,WONOGIRI,36581,WURYANTORO,0,0,0
32676,JAWA TENGAH,34900,WONOSOBO,35121,GARUNG,0,0,0
32676,JAWA TENGAH,34900,WONOSOBO,35172,KALIBAWANG,0,0,0
32676,JAWA TENGAH,34900,WONOSOBO,35021,KALIKAJAR,0,0,0
32676,JAWA TENGAH,34900,WONOSOBO,34959,KALIWIRO,0,0,0
32676,JAWA TENGAH,34900,WONOSOBO,35137,KEJAJAR,0,0,0
32676,JAWA TENGAH,34900,WONOSOBO,34919,KEPIL,0,0,0
32676,JAWA TENGAH,34900,WONOSOBO,35041,KERTEK,0,0,0
32676,JAWA TENGAH,34900,WONOSOBO,34981,LEKSONO,0,0,0
32676,JAWA TENGAH,34900,WONOSOBO,35101,MOJOTENGAH,0,0,0
32676,JAWA TENGAH,34900,WONOSOBO,34941,SAPURAN,0,0,0
32676,JAWA TENGAH,34900,WONOSOBO,34996,SELOMERTO,0,0,0
32676,JAWA TENGAH,34900,WONOSOBO,35154,SUKOHARJO,0,0,0
32676,JAWA TENGAH,34900,WONOSOBO,34901,WADASLINTANG,0,0,0
32676,JAWA TENGAH,34900,WONOSOBO,35084,WATUMALANG,0,0,0
32676,JAWA TENGAH,34900,WONOSOBO,35063,WONOSOBO,0,0,0
42385,JAWA TIMUR,50031,BANGKALAN,50082,AROSBAYA,23969,7952,31921
42385,JAWA TIMUR,50031,BANGKALAN,50032,BANGKALAN,35749,13650,49399
42385,JAWA TIMUR,50031,BANGKALAN,50257,BLEGA,39253,9387,48640
42385,JAWA TIMUR,50031,BANGKALAN,50058,BURNEH,49663,7161,56824
42385,JAWA TIMUR,50031,BANGKALAN,50309,GALIS,63938,7037,70975
42385,JAWA TIMUR,50031,BANGKALAN,50101,GEGER,39657,14196,53853
42385,JAWA TIMUR,50031,BANGKALAN,50071,KAMAL,15740,10840,26580
42385,JAWA TIMUR,50031,BANGKALAN,50115,KLAMPIS,35071,5322,40393
42385,JAWA TIMUR,50031,BANGKALAN,50169,KOKOP,40785,8605,49390
42385,JAWA TIMUR,50031,BANGKALAN,50295,KONANG,40085,7976,48061
42385,JAWA TIMUR,50031,BANGKALAN,50183,KWANYAR,40229,3440,43669
42385,JAWA TIMUR,50031,BANGKALAN,50200,LABANG,21837,8576,30413
42385,JAWA TIMUR,50031,BANGKALAN,50277,MODUNG,27013,7302,34315
42385,JAWA TIMUR,50031,BANGKALAN,50138,SEPULU,25947,10760,36707
42385,JAWA TIMUR,50031,BANGKALAN,50046,SOCAH,27195,11804,38999
42385,JAWA TIMUR,50031,BANGKALAN,50214,TANAH MERAH,59266,7564,66830
42385,JAWA TIMUR,50031,BANGKALAN,50154,TANJUNG BUMI,32684,5178,37862
42385,JAWA TIMUR,50031,BANGKALAN,50238,TRAGAH,26527,2508,29035
42385,JAWA TIMUR,44923,BANYUWANGI,44930,BANGOREJO,0,0,0
42385,JAWA TIMUR,44923,BANYUWANGI,45076,BANYUWANGI,0,0,0
42385,JAWA TIMUR,44923,BANYUWANGI,44968,CLURING,0,0,0
42385,JAWA TIMUR,44923,BANYUWANGI,44978,GAMBIRAN,0,0,0
42385,JAWA TIMUR,44923,BANYUWANGI,44996,GENTENG,0,0,0
42385,JAWA TIMUR,44923,BANYUWANGI,45095,GIRI,0,0,0
42385,JAWA TIMUR,44923,BANYUWANGI,45065,GLAGAH,0,0,0
42385,JAWA TIMUR,44923,BANYUWANGI,45002,GLENMORE,0,0,0
42385,JAWA TIMUR,44923,BANYUWANGI,45048,KABAT,0,0,0
42385,JAWA TIMUR,44923,BANYUWANGI,45010,KALIBARU,0,0,0
42385,JAWA TIMUR,44923,BANYUWANGI,45133,KALIPURO,0,0,0
42385,JAWA TIMUR,44923,BANYUWANGI,45156,LICIN,0,0,0
42385,JAWA TIMUR,44923,BANYUWANGI,44957,MUNCAR,0,0,0
42385,JAWA TIMUR,44923,BANYUWANGI,44924,PESANGGARAN,0,0,0
42385,JAWA TIMUR,44923,BANYUWANGI,44938,PURWOHARJO,0,0,0
42385,JAWA TIMUR,44923,BANYUWANGI,45029,ROGOJAMPI,0,0,0
42385,JAWA TIMUR,44923,BANYUWANGI,45125,SEMPU,0,0,0
42385,JAWA TIMUR,44923,BANYUWANGI,45143,SILIRAGUNG,0,0,0
42385,JAWA TIMUR,44923,BANYUWANGI,45017,SINGOJURUH,0,0,0
42385,JAWA TIMUR,44923,BANYUWANGI,45115,SONGGON,0,0,0
42385,JAWA TIMUR,44923,BANYUWANGI,44985,SRONO,0,0,0
42385,JAWA TIMUR,44923,BANYUWANGI,44947,TEGALDLIMO,0,0,0
42385,JAWA TIMUR,44923,BANYUWANGI,45149,TEGALSARI,0,0,0
42385,JAWA TIMUR,44923,BANYUWANGI,45102,WONGSOREJO,0,0,0
42385,JAWA TIMUR,43360,BLITAR,43418,BAKUNG,5519,10952,16471
42385,JAWA TIMUR,43360,BLITAR,43556,BINANGUN,8245,18144,26389
42385,JAWA TIMUR,43360,BLITAR,43579,DOKO,6599,17159,23758
42385,JAWA TIMUR,43360,BLITAR,43541,GANDUSARI,12196,28264,40460
42385,JAWA TIMUR,43360,BLITAR,43493,GARUM,10446,26506,36952
42385,JAWA TIMUR,43360,BLITAR,43402,KADEMANGAN,10670,28945,39615
42385,JAWA TIMUR,43360,BLITAR,43480,KANIGORO,0,0,0
42385,JAWA TIMUR,43360,BLITAR,43590,KESAMBEN,7735,21964,29699
42385,JAWA TIMUR,43360,BLITAR,43468,NGLEGOK,11279,30777,42056
42385,JAWA TIMUR,43360,BLITAR,43515,PANGGUNGREJO,7064,17912,24976
42385,JAWA TIMUR,43360,BLITAR,43430,PONGGOK,0,0,0
42385,JAWA TIMUR,43360,BLITAR,43446,SANANKULON,9157,22855,32012
42385,JAWA TIMUR,43360,BLITAR,43621,SELOPURO,7810,16741,24551
42385,JAWA TIMUR,43360,BLITAR,43610,SELOREJO,6331,15215,21546
42385,JAWA TIMUR,43360,BLITAR,43386,SRENGAT,10398,27138,37536
42385,JAWA TIMUR,43360,BLITAR,43503,SUTOJAYAN,8719,19216,27935
42385,JAWA TIMUR,43360,BLITAR,43526,TALUN,11594,24578,36172
42385,JAWA TIMUR,43360,BLITAR,43373,UDANAWU,7205,16559,23764
42385,JAWA TIMUR,43360,BLITAR,43601,WATES,3815,13359,17174
42385,JAWA TIMUR,43360,BLITAR,43569,WLINGI,0,0,0
42385,JAWA TIMUR,43360,BLITAR,43361,WONODADI,8057,18884,26941
42385,JAWA TIMUR,43360,BLITAR,43459,WONOTIRTO,0,0,0
42385,JAWA TIMUR,48347,BOJONEGORO,48584,BALEN,21103,17539,38642
42385,JAWA TIMUR,48347,BOJONEGORO,48505,BAURENO,22694,21466,44160
42385,JAWA TIMUR,48347,BOJONEGORO,48630,BOJONEGORO,23221,25552,48773
42385,JAWA TIMUR,48347,BOJONEGORO,48414,BUBULAN,4740,3598,8338
42385,JAWA TIMUR,48347,BOJONEGORO,48420,DANDER,22647,21439,44086
42385,JAWA TIMUR,48347,BOJONEGORO,83884,GAYAM,9599,8504,18103
42385,JAWA TIMUR,48347,BOJONEGORO,48790,GONDANG,5783,8806,14589
42385,JAWA TIMUR,48347,BOJONEGORO,48649,KALITIDU,15886,11999,27885
42385,JAWA TIMUR,48347,BOJONEGORO,48531,KANOR,19040,14050,33090
42385,JAWA TIMUR,48347,BOJONEGORO,48608,KAPAS,17280,14009,31289
42385,JAWA TIMUR,48347,BOJONEGORO,48725,KASIMAN,7754,9636,17390
42385,JAWA TIMUR,48347,BOJONEGORO,48784,KEDEWAN,2400,4750,7150
42385,JAWA TIMUR,48347,BOJONEGORO,48455,KEDUNGADEM,27605,18303,45908
42385,JAWA TIMUR,48347,BOJONEGORO,48479,KEPOH BARU,20631,16057,36688
42385,JAWA TIMUR,48347,BOJONEGORO,48674,MALO,10359,7215,17574
42385,JAWA TIMUR,48347,BOJONEGORO,48749,MARGOMULYO,4642,8076,12718
42385,JAWA TIMUR,48347,BOJONEGORO,48384,NGAMBON,3172,3403,6575
42385,JAWA TIMUR,48347,BOJONEGORO,48390,NGASEM,16967,16385,33352
42385,JAWA TIMUR,48347,BOJONEGORO,48348,NGRAHO,10501,14443,24944
42385,JAWA TIMUR,48347,BOJONEGORO,48708,PADANGAN,11060,12567,23627
42385,JAWA TIMUR,48347,BOJONEGORO,48695,PURWOSARI,7946,8210,16156
42385,JAWA TIMUR,48347,BOJONEGORO,48798,SEKAR,5445,9854,15299
42385,JAWA TIMUR,48347,BOJONEGORO,48437,SUGIHWARAS,15117,11098,26215
42385,JAWA TIMUR,48347,BOJONEGORO,48769,SUKOSEWU,12048,12173,24221
42385,JAWA TIMUR,48347,BOJONEGORO,48557,SUMBEREJO,24320,16116,40436
42385,JAWA TIMUR,48347,BOJONEGORO,48365,TAMBAKREJO,13961,16942,30903
42385,JAWA TIMUR,48347,BOJONEGORO,48736,TEMAYANG,11098,9562,20660
42385,JAWA TIMUR,48347,BOJONEGORO,48756,TRUCUK,10258,10555,20813
42385,JAWA TIMUR,45165,BONDOWOSO,45371,BINAKAL,5158,4363,9521
42385,JAWA TIMUR,45165,BONDOWOSO,45278,BONDOWOSO,24342,18119,42461
42385,JAWA TIMUR,45165,BONDOWOSO,45398,BOTOLINGGO,14598,4859,19457
42385,JAWA TIMUR,45165,BONDOWOSO,45325,CERMEE,19344,8345,27689
42385,JAWA TIMUR,45165,BONDOWOSO,45229,CURAHDAMI,10973,7369,18342
42385,JAWA TIMUR,45165,BONDOWOSO,45217,GRUJUGAN,13533,6574,20107
42385,JAWA TIMUR,45165,BONDOWOSO,45388,JAMBESARI DARUS SHOLAH,12528,6680,19208
42385,JAWA TIMUR,45165,BONDOWOSO,45313,KLABANG,8031,3676,11707
42385,JAWA TIMUR,45165,BONDOWOSO,45166,MAESAN,14705,11612,26317
42385,JAWA TIMUR,45165,BONDOWOSO,45348,PAKEM,5547,8291,13838
42385,JAWA TIMUR,45165,BONDOWOSO,45340,PRAJEKAN,11161,4564,15725
42385,JAWA TIMUR,45165,BONDOWOSO,45205,PUJER,15999,7354,23353
42385,JAWA TIMUR,45165,BONDOWOSO,45364,SEMPOL,4944,2952,7896
42385,JAWA TIMUR,45165,BONDOWOSO,45200,SUKOSARI,6200,2882,9082
42385,JAWA TIMUR,45165,BONDOWOSO,45357,SUMBERWRINGIN,11085,8091,19176
42385,JAWA TIMUR,45165,BONDOWOSO,45380,TAMAN KROCOK,5982,4726,10708
42385,JAWA TIMUR,45165,BONDOWOSO,45179,TAMANAN,11387,9849,21236
42385,JAWA TIMUR,45165,BONDOWOSO,45268,TAPEN,13384,7359,20743
42385,JAWA TIMUR,45165,BONDOWOSO,45304,TEGALAMPEL,7236,7193,14429
42385,JAWA TIMUR,45165,BONDOWOSO,45242,TENGGARANG,13640,9602,23242
42385,JAWA TIMUR,45165,BONDOWOSO,45189,TLOGOSARI,15739,9326,25065
42385,JAWA TIMUR,45165,BONDOWOSO,45255,WONOSARI,13686,10364,24050
42385,JAWA TIMUR,45165,BONDOWOSO,45290,WRINGIN,11576,11353,22929
42385,JAWA TIMUR,49656,GRESIK,49684,BALONGPANGGANG,16806,15889,32695
42385,JAWA TIMUR,49656,GRESIK,49725,BENJENG,17983,18830,36813
42385,JAWA TIMUR,49656,GRESIK,49892,BUNGAH,18548,16120,34668
42385,JAWA TIMUR,49656,GRESIK,49866,CERME,22480,21109,43589
42385,JAWA TIMUR,49656,GRESIK,49960,DRIYOREJO,24881,28411,53292
42385,JAWA TIMUR,49656,GRESIK,49749,DUDUKSAMPEYAN,17913,10315,28228
42385,JAWA TIMUR,49656,GRESIK,49657,DUKUN,21303,11191,32494
42385,JAWA TIMUR,49656,GRESIK,49977,GRESIK,23747,18494,42241
42385,JAWA TIMUR,49656,GRESIK,49938,KEBOMAS,29405,25286,54691
42385,JAWA TIMUR,49656,GRESIK,49804,KEDAMEAN,14425,22297,36722
42385,JAWA TIMUR,49656,GRESIK,49842,MANYAR,33493,22415,55908
42385,JAWA TIMUR,49656,GRESIK,49915,MENGANTI,24456,40606,65062
42385,JAWA TIMUR,49656,GRESIK,49710,PANCENG,15201,9317,24518
42385,JAWA TIMUR,49656,GRESIK,49999,SANGKAPURA,15366,8170,23536
42385,JAWA TIMUR,49656,GRESIK,49820,SIDAYU,13176,8089,21265
42385,JAWA TIMUR,49656,GRESIK,50017,TAMBAK,7131,4678,11809
42385,JAWA TIMUR,49656,GRESIK,49790,UJUNGPANGKAH,14888,10255,25143
42385,JAWA TIMUR,49656,GRESIK,49773,WRINGINANOM,19753,21024,40777
42385,JAWA TIMUR,44643,JEMBER,44786,AJUNG,0,0,0
42385,JAWA TIMUR,44643,JEMBER,44746,AMBULU,0,0,0
42385,JAWA TIMUR,44643,JEMBER,44828,ARJASA,0,0,0
42385,JAWA TIMUR,44643,JEMBER,44729,BALUNG,0,0,0
42385,JAWA TIMUR,44643,JEMBER,44717,BANGSALSARI,0,0,0
42385,JAWA TIMUR,44643,JEMBER,44668,GUMUKMAS,0,0,0
42385,JAWA TIMUR,44643,JEMBER,44851,JELBUK,0,0,0
42385,JAWA TIMUR,44643,JEMBER,44777,JENGGAWAH,0,0,0
42385,JAWA TIMUR,44643,JEMBER,44644,JOMBANG,0,0,0
42385,JAWA TIMUR,44643,JEMBER,44866,KALISAT,0,0,0
42385,JAWA TIMUR,44643,JEMBER,44803,KALIWATES,0,0,0
42385,JAWA TIMUR,44643,JEMBER,44651,KENCONG,0,0,0
42385,JAWA TIMUR,44643,JEMBER,44879,LEDOKOMBO,0,0,0
42385,JAWA TIMUR,44643,JEMBER,44858,MAYANG,0,0,0
42385,JAWA TIMUR,44643,JEMBER,44835,MUMBULSARI,0,0,0
42385,JAWA TIMUR,44643,JEMBER,44843,PAKUSARI,0,0,0
42385,JAWA TIMUR,44643,JEMBER,44763,PANTI,0,0,0
42385,JAWA TIMUR,44643,JEMBER,44811,PATRANG,0,0,0
42385,JAWA TIMUR,44643,JEMBER,44704,PUGER,0,0,0
42385,JAWA TIMUR,44643,JEMBER,44754,RAMBIPUJI,0,0,0
42385,JAWA TIMUR,44643,JEMBER,44697,SEMBORO,0,0,0
42385,JAWA TIMUR,44643,JEMBER,44903,SILO,0,0,0
42385,JAWA TIMUR,44643,JEMBER,44771,SUKORAMBI,0,0,0
42385,JAWA TIMUR,44643,JEMBER,44890,SUKOWONO,0,0,0
42385,JAWA TIMUR,44643,JEMBER,44657,SUMBERBARU,0,0,0
42385,JAWA TIMUR,44643,JEMBER,44913,SUMBERJAMBE,0,0,0
42385,JAWA TIMUR,44643,JEMBER,44820,SUMBERSARI,0,0,0
42385,JAWA TIMUR,44643,JEMBER,44688,TANGGUL,0,0,0
42385,JAWA TIMUR,44643,JEMBER,44794,TEMPUREJO,0,0,0
42385,JAWA TIMUR,44643,JEMBER,44677,UMBULSARI,0,0,0
42385,JAWA TIMUR,44643,JEMBER,44738,WULUHAN,0,0,0
42385,JAWA TIMUR,47001,JOMBANG,47279,BANDARKEDUNGMULYO,11269,13750,25019
42385,JAWA TIMUR,47001,JOMBANG,47049,BARENG,8931,21853,30784
42385,JAWA TIMUR,47001,JOMBANG,47112,DIWEK,5612,7843,13455
42385,JAWA TIMUR,47001,JOMBANG,47016,GUDO,13321,17416,30737
42385,JAWA TIMUR,47001,JOMBANG,47291,JOGOROTO,15377,19500,34877
42385,JAWA TIMUR,47001,JOMBANG,47133,JOMBANG,34215,42307,76522
42385,JAWA TIMUR,47001,JOMBANG,47250,KABUH,12640,13211,25851
42385,JAWA TIMUR,47001,JOMBANG,47191,KESAMBEN,16019,20891,36910
42385,JAWA TIMUR,47001,JOMBANG,47267,KUDU,8508,10420,18928
42385,JAWA TIMUR,47001,JOMBANG,47303,MEGALUH,10576,12117,22693
42385,JAWA TIMUR,47001,JOMBANG,47073,MOJOAGUNG,16378,25980,42358
42385,JAWA TIMUR,47001,JOMBANG,47092,MOJOWARNO,18213,32254,50467
42385,JAWA TIMUR,47001,JOMBANG,47035,NGORO,14571,25711,40282
42385,JAWA TIMUR,47001,JOMBANG,47317,NGUSIKAN,6827,7016,13843
42385,JAWA TIMUR,47001,JOMBANG,47002,PERAK,13565,15109,28674
42385,JAWA TIMUR,47001,JOMBANG,47154,PETERONGAN,15825,20758,36583
42385,JAWA TIMUR,47001,JOMBANG,47236,PLANDAAN,12794,10781,23575
42385,JAWA TIMUR,47001,JOMBANG,47222,PLOSO,9845,14447,24292
42385,JAWA TIMUR,47001,JOMBANG,47169,SUMOBITO,19243,26715,45958
42385,JAWA TIMUR,47001,JOMBANG,47206,TEMBELANG,14058,16737,30795
42385,JAWA TIMUR,47001,JOMBANG,47063,WONOSALAM,6233,12019,18252
42385,JAWA TIMUR,43630,KEDIRI,43984,BADAS,14019,21740,35759
42385,JAWA TIMUR,43630,KEDIRI,43936,BANYAKAN,11505,22148,33653
42385,JAWA TIMUR,43630,KEDIRI,43796,GAMPENGREJO,7366,12518,19884
42385,JAWA TIMUR,43630,KEDIRI,43808,GROGOL,9367,16467,25834
42385,JAWA TIMUR,43630,KEDIRI,43760,GURAH,15386,32517,47903
42385,JAWA TIMUR,43630,KEDIRI,43899,KANDANGAN,8494,19369,27863
42385,JAWA TIMUR,43630,KEDIRI,43699,KANDAT,9252,25869,35121
42385,JAWA TIMUR,43630,KEDIRI,43958,KAYEN KIDUL,9247,18699,27946
42385,JAWA TIMUR,43630,KEDIRI,43888,KEPUNG,13876,32364,46240
42385,JAWA TIMUR,43630,KEDIRI,43665,KRAS,10200,25411,35611
42385,JAWA TIMUR,43630,KEDIRI,43923,KUNJANG,8254,12992,21246
42385,JAWA TIMUR,43630,KEDIRI,43644,MOJO,16808,26336,43144
42385,JAWA TIMUR,43630,KEDIRI,43682,NGADILUWIH,13208,31739,44947
42385,JAWA TIMUR,43630,KEDIRI,43724,NGANCAR,5982,21727,27709
42385,JAWA TIMUR,43630,KEDIRI,43971,NGASEM,13247,25408,38655
42385,JAWA TIMUR,43630,KEDIRI,43782,PAGU,8230,15183,23413
42385,JAWA TIMUR,43630,KEDIRI,43818,PAPAR,10871,18902,29773
42385,JAWA TIMUR,43630,KEDIRI,43878,PARE,20674,37748,58422
42385,JAWA TIMUR,43630,KEDIRI,43860,PLEMAHAN,12677,21906,34583
42385,JAWA TIMUR,43630,KEDIRI,43744,PLOSOKLATEN,11969,29200,41169
42385,JAWA TIMUR,43630,KEDIRI,43735,PUNCU,10074,25737,35811
42385,JAWA TIMUR,43630,KEDIRI,43836,PURWOASRI,11936,21501,33437
42385,JAWA TIMUR,43630,KEDIRI,43946,RINGINREJO,9061,21873,30934
42385,JAWA TIMUR,43630,KEDIRI,43631,SEMEN,9707,20914,30621
42385,JAWA TIMUR,43630,KEDIRI,43912,TAROKAN,9554,22442,31996
42385,JAWA TIMUR,43630,KEDIRI,43712,WATES,13465,38746,52211
42385,JAWA TIMUR,51550,KOTA BATU,51551,BATU,46979,73055,120034
42385,JAWA TIMUR,51550,KOTA BATU,51560,BUMIAJI,13441,22958,36399
42385,JAWA TIMUR,51550,KOTA BATU,51570,JUNREJO,11900,17326,29226
42385,JAWA TIMUR,51145,KOTA BLITAR,51146,KEPANJENKIDUL,8305,16391,24696
42385,JAWA TIMUR,51145,KOTA BLITAR,51162,SANANWETAN,12217,18605,30822
42385,JAWA TIMUR,51145,KOTA BLITAR,51154,SUKOREJO,8827,19603,28430
42385,JAWA TIMUR,51095,KOTA KEDIRI,51111,KOTA,16532,33583,50115
42385,JAWA TIMUR,51095,KOTA KEDIRI,51096,MOJOROTO,25896,35205,61101
42385,JAWA TIMUR,51095,KOTA KEDIRI,51129,PESANTREN,17033,31704,48737
42385,JAWA TIMUR,51327,KOTA MADIUN,51328,KARTOHARJO,12437,17578,30015
42385,JAWA TIMUR,51327,KOTA MADIUN,51338,MANGUHARJO,11306,19986,31292
42385,JAWA TIMUR,51327,KOTA MADIUN,51348,TAMAN,17305,27495,44800
42385,JAWA TIMUR,51170,KOTA MALANG,51171,BLIMBING,41075,57906,98981
42385,JAWA TIMUR,51170,KOTA MALANG,51195,KEDUNGKANDANG,42327,56501,98828
42385,JAWA TIMUR,51170,KOTA MALANG,51183,KLOJEN,23595,35657,59252
42385,JAWA TIMUR,51170,KOTA MALANG,51220,LOWOKWARU,37623,52068,89691
42385,JAWA TIMUR,51170,KOTA MALANG,51208,SUKUN,37508,68839,106347
42385,JAWA TIMUR,51306,KOTA MOJOKERTO,51316,MAGERSARI,17867,23274,41141
42385,JAWA TIMUR,51306,KOTA MOJOKERTO,51307,PRAJURIT KULON,14839,18230,33069
42385,JAWA TIMUR,51268,KOTA PASURUAN,51292,BUGUL KIDUL,9681,6086,15767
42385,JAWA TIMUR,51268,KOTA PASURUAN,51269,GADINGREJO,12537,10327,22864
42385,JAWA TIMUR,51268,KOTA PASURUAN,83540,PANGGUNGREJO,19286,14585,33871
42385,JAWA TIMUR,51268,KOTA PASURUAN,51281,PURWOREJO,17463,12898,30361
42385,JAWA TIMUR,51233,KOTA PROBOLINGGO,51234,KADEMANGAN,12942,10230,23172
42385,JAWA TIMUR,51233,KOTA PROBOLINGGO,83538,KANIGARAN,17950,14000,31950
42385,JAWA TIMUR,51233,KOTA PROBOLINGGO,83539,KEDOPAK,10921,7361,18282
42385,JAWA TIMUR,51233,KOTA PROBOLINGGO,51248,MAYANGAN,16727,18771,35498
42385,JAWA TIMUR,51233,KOTA PROBOLINGGO,51241,WONOASIH,10572,7787,18359
42385,JAWA TIMUR,51358,KOTA SURABAYA,51527,ASEM ROWO,0,0,0
42385,JAWA TIMUR,51358,KOTA SURABAYA,51476,BENOWO,0,0,0
42385,JAWA TIMUR,51358,KOTA SURABAYA,51439,BUBUTAN,0,0,0
42385,JAWA TIMUR,51358,KOTA SURABAYA,51533,BULAK,0,0,0
42385,JAWA TIMUR,51358,KOTA SURABAYA,51487,DUKUHPAKIS,0,0,0
42385,JAWA TIMUR,51358,KOTA SURABAYA,51492,GAYUNGAN,0,0,0
42385,JAWA TIMUR,51358,KOTA SURABAYA,51397,GENTENG,0,0,0
42385,JAWA TIMUR,51358,KOTA SURABAYA,51403,GUBENG,0,0,0
42385,JAWA TIMUR,51358,KOTA SURABAYA,51508,GUNUNG ANYAR,0,0,0
42385,JAWA TIMUR,51358,KOTA SURABAYA,51497,JAMBANGAN,0,0,0
42385,JAWA TIMUR,51358,KOTA SURABAYA,51359,KARANGPILANG,0,0,0
42385,JAWA TIMUR,51358,KOTA SURABAYA,51464,KENJERAN,0,0,0
42385,JAWA TIMUR,51358,KOTA SURABAYA,51452,KREMBANGAN,0,0,0
42385,JAWA TIMUR,51358,KOTA SURABAYA,51469,LAKARSANTRI,0,0,0
42385,JAWA TIMUR,51358,KOTA SURABAYA,51513,MULYOREJO,0,0,0
42385,JAWA TIMUR,51358,KOTA SURABAYA,51433,PABEAN CANTIKAN,0,0,0
42385,JAWA TIMUR,51358,KOTA SURABAYA,51539,PAKAL,0,0,0
42385,JAWA TIMUR,51358,KOTA SURABAYA,51370,RUNGKUT,0,0,0
42385,JAWA TIMUR,51358,KOTA SURABAYA,51545,SAMBIKEREP,0,0,0
42385,JAWA TIMUR,51358,KOTA SURABAYA,51390,SAWAHAN,0,0,0
42385,JAWA TIMUR,51358,KOTA SURABAYA,51458,SEMAMPIR,0,0,0
42385,JAWA TIMUR,51358,KOTA SURABAYA,51427,SIMOKERTO,0,0,0
42385,JAWA TIMUR,51358,KOTA SURABAYA,51410,SUKOLILO,0,0,0
42385,JAWA TIMUR,51358,KOTA SURABAYA,51520,SUKOMANUNGGAL,0,0,0
42385,JAWA TIMUR,51358,KOTA SURABAYA,51418,TAMBAKSARI,0,0,0
42385,JAWA TIMUR,51358,KOTA SURABAYA,51445,TANDES,0,0,0
42385,JAWA TIMUR,51358,KOTA SURABAYA,51384,TEGALSARI,0,0,0
42385,JAWA TIMUR,51358,KOTA SURABAYA,51502,TENGGILIS MEJOYO,0,0,0
42385,JAWA TIMUR,51358,KOTA SURABAYA,51482,WIYUNG,0,0,0
42385,JAWA TIMUR,51358,KOTA SURABAYA,51364,WONOCOLO,0,0,0
42385,JAWA TIMUR,51358,KOTA SURABAYA,51377,WONOKROMO,0,0,0
42385,JAWA TIMUR,49154,LAMONGAN,49213,BABAT,20396,23267,43663
42385,JAWA TIMUR,49154,LAMONGAN,49165,BLULUK,7367,5864,13231
42385,JAWA TIMUR,49154,LAMONGAN,49261,BRONDONG,17302,16584,33886
42385,JAWA TIMUR,49154,LAMONGAN,49598,DEKET,13791,10648,24439
42385,JAWA TIMUR,49154,LAMONGAN,49616,GLAGAH,11767,9759,21526
42385,JAWA TIMUR,49154,LAMONGAN,49500,KALITENGAH,9831,8859,18690
42385,JAWA TIMUR,49154,LAMONGAN,49576,KARANGBINANGUN,10514,9538,20052
42385,JAWA TIMUR,49154,LAMONGAN,49462,KARANGGENENG,10862,11184,22046
42385,JAWA TIMUR,49154,LAMONGAN,49237,KEDUNGPRING,16723,14800,31523
42385,JAWA TIMUR,49154,LAMONGAN,49481,KEMBANGBAHU,12627,16429,29056
42385,JAWA TIMUR,49154,LAMONGAN,49541,LAMONGAN,20436,18204,38640
42385,JAWA TIMUR,49154,LAMONGAN,49272,LAREN,12734,9263,21997
42385,JAWA TIMUR,49154,LAMONGAN,49315,MADURAN,8206,7851,16057
42385,JAWA TIMUR,49154,LAMONGAN,49425,MANTUP,14300,13855,28155
42385,JAWA TIMUR,49154,LAMONGAN,49175,MODO,15959,12673,28632
42385,JAWA TIMUR,49154,LAMONGAN,49193,NGIMBANG,14802,12903,27705
42385,JAWA TIMUR,49154,LAMONGAN,49396,PACIRAN,28905,18094,46999
42385,JAWA TIMUR,49154,LAMONGAN,49378,PUCUK,10391,12886,23277
42385,JAWA TIMUR,49154,LAMONGAN,49333,SAMBENG,16081,15487,31568
42385,JAWA TIMUR,49154,LAMONGAN,49646,SARIREJO,8021,5694,13715
42385,JAWA TIMUR,49154,LAMONGAN,49293,SEKARAN,9309,10423,19732
42385,JAWA TIMUR,49154,LAMONGAN,49414,SOLOKURO,13703,9138,22841
42385,JAWA TIMUR,49154,LAMONGAN,49356,SUGIO,15325,18749,34074
42385,JAWA TIMUR,49154,LAMONGAN,49441,SUKODADI,15812,15535,31347
42385,JAWA TIMUR,49154,LAMONGAN,49155,SUKORAME,7102,5729,12831
42385,JAWA TIMUR,49154,LAMONGAN,49562,TIKUNG,11189,14686,25875
42385,JAWA TIMUR,49154,LAMONGAN,49521,TURI,15131,14147,29278
42385,JAWA TIMUR,44417,LUMAJANG,44433,CANDIPURO,11381,25790,37171
42385,JAWA TIMUR,44417,LUMAJANG,44545,GUCIALIT,0,0,0
42385,JAWA TIMUR,44417,LUMAJANG,44589,JATIROTO,0,0,0
42385,JAWA TIMUR,44417,LUMAJANG,44576,KEDUNGJAJANG,0,0,0
42385,JAWA TIMUR,44417,LUMAJANG,44609,KLAKAH,16359,10336,26695
42385,JAWA TIMUR,44417,LUMAJANG,44470,KUNIR,0,0,0
42385,JAWA TIMUR,44417,LUMAJANG,44511,LUMAJANG,0,0,0
42385,JAWA TIMUR,44417,LUMAJANG,44555,PADANG,0,0,0
42385,JAWA TIMUR,44417,LUMAJANG,44444,PASIRIAN,16285,32152,48437
42385,JAWA TIMUR,44417,LUMAJANG,44524,PASRUJAMBE,7063,13338,20401
42385,JAWA TIMUR,44417,LUMAJANG,44426,PRONOJIWO,6334,11428,17762
42385,JAWA TIMUR,44417,LUMAJANG,44596,RANDUAGUNG,0,0,0
42385,JAWA TIMUR,44417,LUMAJANG,44622,RANUYOSO,0,0,0
42385,JAWA TIMUR,44417,LUMAJANG,44494,ROWOKANGKUNG,8658,11691,20349
42385,JAWA TIMUR,44417,LUMAJANG,44532,SENDURO,0,0,0
42385,JAWA TIMUR,44417,LUMAJANG,44565,SUKODONO,14360,15200,29560
42385,JAWA TIMUR,44417,LUMAJANG,44634,SUMBERSUKO,0,0,0
42385,JAWA TIMUR,44417,LUMAJANG,44502,TEKUNG,8668,10536,19204
42385,JAWA TIMUR,44417,LUMAJANG,44456,TEMPEH,0,0,0
42385,JAWA TIMUR,44417,LUMAJANG,44418,TEMPURSARI,0,0,0
42385,JAWA TIMUR,44417,LUMAJANG,44482,YOSOWILANGUN,15243,18362,33605
42385,JAWA TIMUR,47634,MADIUN,47762,BALEREJO,11601,15542,27143
42385,JAWA TIMUR,47634,MADIUN,47683,DAGANGAN,12267,15885,28152
42385,JAWA TIMUR,47634,MADIUN,47650,DOLOPO,12674,20181,32855
42385,JAWA TIMUR,47634,MADIUN,47663,GEGER,15085,21624,36709
42385,JAWA TIMUR,47634,MADIUN,47710,GEMARANG,7190,11121,18311
42385,JAWA TIMUR,47634,MADIUN,47747,JIWAN,15440,19457,34897
42385,JAWA TIMUR,47634,MADIUN,47701,KARE,6878,11483,18361
42385,JAWA TIMUR,47634,MADIUN,47635,KEBONSARI,15796,16625,32421
42385,JAWA TIMUR,47634,MADIUN,47733,MADIUN,9909,13976,23885
42385,JAWA TIMUR,47634,MADIUN,47781,MEJAYAN,11341,14648,25989
42385,JAWA TIMUR,47634,MADIUN,47812,PILANGKENCENG,13025,18708,31733
42385,JAWA TIMUR,47634,MADIUN,47796,SARADAN,17605,20689,38294
42385,JAWA TIMUR,47634,MADIUN,47831,SAWAHAN,7170,8417,15587
42385,JAWA TIMUR,47634,MADIUN,47845,WONOASRI,8388,11668,20056
42385,JAWA TIMUR,47634,MADIUN,47718,WUNGU,13623,19978,33601
42385,JAWA TIMUR,47856,MAGETAN,48022,BARAT,8694,9536,18230
42385,JAWA TIMUR,47856,MAGETAN,47989,BENDO,11498,13687,25185
42385,JAWA TIMUR,47856,MAGETAN,48037,KARANGREJO,7296,6784,14080
42385,JAWA TIMUR,47856,MAGETAN,48051,KARAS,12431,8955,21386
42385,JAWA TIMUR,47856,MAGETAN,48063,KARTOHARJO,7176,8465,15641
42385,JAWA TIMUR,47856,MAGETAN,47904,KAWEDANAN,12294,12557,24851
42385,JAWA TIMUR,47856,MAGETAN,47880,LEMBEYAN,14007,10572,24579
42385,JAWA TIMUR,47856,MAGETAN,47925,MAGETAN,14083,12294,26377
42385,JAWA TIMUR,47856,MAGETAN,48006,MAOSPATI,11678,14344,26022
42385,JAWA TIMUR,47856,MAGETAN,48076,NGARIBOYO,12366,10067,22433
42385,JAWA TIMUR,47856,MAGETAN,48089,NGUNTORONADI,6169,6310,12479
42385,JAWA TIMUR,47856,MAGETAN,47956,PANEKAN,15700,16969,32669
42385,JAWA TIMUR,47856,MAGETAN,47866,PARANG,15500,9689,25189
42385,JAWA TIMUR,47856,MAGETAN,47940,PLAOSAN,18155,13361,31516
42385,JAWA TIMUR,47856,MAGETAN,47857,PONCOL,10727,6962,17689
42385,JAWA TIMUR,47856,MAGETAN,48099,SIDOREJO,7791,8786,16577
42385,JAWA TIMUR,47856,MAGETAN,47974,SUKOMORO,8999,10262,19261
42385,JAWA TIMUR,47856,MAGETAN,47891,TAKERAN,11382,11362,22744
42385,JAWA TIMUR,43993,MALANG,44054,AMPELGADING,11041,20283,31324
42385,JAWA TIMUR,43993,MALANG,44014,BANTUR,11490,27125,38615
42385,JAWA TIMUR,43993,MALANG,44170,BULULAWANG,16368,22176,38544
42385,JAWA TIMUR,43993,MALANG,44041,DAMPIT,23493,44284,67777
42385,JAWA TIMUR,43993,MALANG,44282,DAU,14642,23245,37887
42385,JAWA TIMUR,43993,MALANG,43994,DONOMULYO,8124,28058,36182
42385,JAWA TIMUR,43993,MALANG,44366,GEDANGAN,10392,19496,29888
42385,JAWA TIMUR,43993,MALANG,44118,GONDANGLEGI,21691,20994,42685
42385,JAWA TIMUR,43993,MALANG,44214,JABUNG,16375,24634,41009
42385,JAWA TIMUR,43993,MALANG,44133,KALIPARE,10357,25462,35819
42385,JAWA TIMUR,43993,MALANG,44293,KARANG PLOSO,16550,26544,43094
42385,JAWA TIMUR,43993,MALANG,44359,KASEMBON,6467,10756,17223
42385,JAWA TIMUR,43993,MALANG,44151,KEPANJEN,24592,33423,58015
42385,JAWA TIMUR,43993,MALANG,44389,KROMENGAN,8705,14408,23113
42385,JAWA TIMUR,43993,MALANG,44321,LAWANG,31481,27924,59405
42385,JAWA TIMUR,43993,MALANG,44259,NGAJUNG,10923,17569,28492
42385,JAWA TIMUR,43993,MALANG,44345,NGANTANG,13231,20276,33507
42385,JAWA TIMUR,43993,MALANG,44005,PAGAK,8556,16916,25472
42385,JAWA TIMUR,43993,MALANG,44406,PAGELARAN,16837,19771,36608
42385,JAWA TIMUR,43993,MALANG,44230,PAKIS,30173,45765,75938
42385,JAWA TIMUR,43993,MALANG,44246,PAKISAJI,17836,31259,49095
42385,JAWA TIMUR,43993,MALANG,44068,PONCOKUSUMO,23156,31534,54690
42385,JAWA TIMUR,43993,MALANG,44334,PUJON,17902,21338,39240
42385,JAWA TIMUR,43993,MALANG,44303,SINGOSARI,43782,47263,91045
42385,JAWA TIMUR,43993,MALANG,44025,SUMBERMANJING WETAN,17100,35864,52964
42385,JAWA TIMUR,43993,MALANG,44143,SUMBERPUCUNG,11167,19486,30653
42385,JAWA TIMUR,43993,MALANG,44185,TAJINAN,12151,18668,30819
42385,JAWA TIMUR,43993,MALANG,44375,TIRTOYUDO,12393,23289,35682
42385,JAWA TIMUR,43993,MALANG,44198,TUMPANG,17312,27449,44761
42385,JAWA TIMUR,43993,MALANG,44100,TUREN,24055,40702,64757
42385,JAWA TIMUR,43993,MALANG,44269,WAGIR,14463,34501,48964
42385,JAWA TIMUR,43993,MALANG,44086,WAJAK,17281,30008,47289
42385,JAWA TIMUR,43993,MALANG,44397,WONOSARI,9537,15171,24708
42385,JAWA TIMUR,46678,MOJOKERTO,46848,BANGSAL,13542,16438,29980
42385,JAWA TIMUR,46678,MOJOKERTO,46969,DAWARBLANDONG,13119,19030,32149
42385,JAWA TIMUR,46678,MOJOKERTO,46831,DLANGGU,10625,20087,30712
42385,JAWA TIMUR,46678,MOJOKERTO,46916,GEDEG,13890,19132,33022
42385,JAWA TIMUR,46678,MOJOKERTO,46699,GONDANG,10145,14868,25013
42385,JAWA TIMUR,46678,MOJOKERTO,46679,JATIREJO,9017,15006,24023
42385,JAWA TIMUR,46678,MOJOKERTO,46952,JETIS,19497,28982,48479
42385,JAWA TIMUR,46678,MOJOKERTO,46931,KEMLAGI,14608,19303,33911
42385,JAWA TIMUR,46678,MOJOKERTO,46793,KUTOREJO,14576,21934,36510
42385,JAWA TIMUR,46678,MOJOKERTO,46988,MOJOANYAR,12423,15555,27978
42385,JAWA TIMUR,46678,MOJOKERTO,46811,MOJOSARI,18287,25289,43576
42385,JAWA TIMUR,46678,MOJOKERTO,46753,NGORO,22878,22382,45260
42385,JAWA TIMUR,46678,MOJOKERTO,46718,PACET,13049,20911,33960
42385,JAWA TIMUR,46678,MOJOKERTO,46773,PUNGGING,20125,25402,45527
42385,JAWA TIMUR,46678,MOJOKERTO,46866,PURI,16389,25000,41389
42385,JAWA TIMUR,46678,MOJOKERTO,46900,SOOKO,17418,21706,39124
42385,JAWA TIMUR,46678,MOJOKERTO,46739,TRAWAS,6709,11742,18451
42385,JAWA TIMUR,46678,MOJOKERTO,46883,TROWULAN,14058,27498,41556
42385,JAWA TIMUR,47329,NGANJUK,47526,BAGOR,17014,18906,35920
42385,JAWA TIMUR,47329,NGANJUK,47468,BARON,10408,18111,28519
42385,JAWA TIMUR,47329,NGANJUK,47350,BERBEK,12635,19058,31693
42385,JAWA TIMUR,47329,NGANJUK,47580,GONDANG,11161,20277,31438
42385,JAWA TIMUR,47329,NGANJUK,47622,JATIKALEN,7009,5322,12331
42385,JAWA TIMUR,47329,NGANJUK,47441,KERTOSONO,11511,19047,30558
42385,JAWA TIMUR,47329,NGANJUK,47605,LENGKONG,10154,9202,19356
42385,JAWA TIMUR,47329,NGANJUK,47370,LOCERET,14377,25685,40062
42385,JAWA TIMUR,47329,NGANJUK,47510,NGANJUK,14979,23401,38380
42385,JAWA TIMUR,47329,NGANJUK,47340,NGETOS,5556,13690,19246
42385,JAWA TIMUR,47329,NGANJUK,47598,NGLUYU,5164,3976,9140
42385,JAWA TIMUR,47329,NGANJUK,47427,NGRONGGOT,14150,29313,43463
42385,JAWA TIMUR,47329,NGANJUK,47393,PACE,10805,24141,34946
42385,JAWA TIMUR,47329,NGANJUK,47456,PATIANROWO,9968,13878,23846
42385,JAWA TIMUR,47329,NGANJUK,47412,PRAMBON,13905,26361,40266
42385,JAWA TIMUR,47329,NGANJUK,47555,REJOSO,17830,24094,41924
42385,JAWA TIMUR,47329,NGANJUK,47330,SAWAHAN,7974,13813,21787
42385,JAWA TIMUR,47329,NGANJUK,47497,SUKOMORO,8794,17356,26150
42385,JAWA TIMUR,47329,NGANJUK,47480,TANJUNGANOM,21411,42068,63479
42385,JAWA TIMUR,47329,NGANJUK,47548,WILANGAN,7701,9200,16901
42385,JAWA TIMUR,48110,NGAWI,48302,BRINGIN,6436,12197,18633
42385,JAWA TIMUR,48110,NGAWI,48166,GENENG,12644,18298,30942
42385,JAWA TIMUR,48110,NGAWI,48332,GERIH,7386,12515,19901
42385,JAWA TIMUR,48110,NGAWI,48142,JOGOROGO,9149,13140,22289
42385,JAWA TIMUR,48110,NGAWI,48324,KARANGANYAR,4362,12728,17090
42385,JAWA TIMUR,48110,NGAWI,48195,KARANGJATI,11666,18579,30245
42385,JAWA TIMUR,48110,NGAWI,48338,KASREMAN,6070,8507,14577
42385,JAWA TIMUR,48110,NGAWI,48258,KEDUNGGALAR,15004,24108,39112
42385,JAWA TIMUR,48110,NGAWI,48155,KENDAL,11474,15830,27304
42385,JAWA TIMUR,48110,NGAWI,48180,KWADUNGAN,7551,9297,16848
42385,JAWA TIMUR,48110,NGAWI,48284,MANTINGAN,8944,13519,22463
42385,JAWA TIMUR,48110,NGAWI,48226,NGAWI,23226,26186,49412
42385,JAWA TIMUR,48110,NGAWI,48127,NGRAMBE,8537,14927,23464
42385,JAWA TIMUR,48110,NGAWI,48213,PADAS,7621,14141,21762
42385,JAWA TIMUR,48110,NGAWI,48292,PANGKUR,8302,9440,17742
42385,JAWA TIMUR,48110,NGAWI,48243,PARON,22225,29952,52177
42385,JAWA TIMUR,48110,NGAWI,48313,PITU,8241,9004,17245
42385,JAWA TIMUR,48110,NGAWI,48111,SINE,8202,16248,24450
42385,JAWA TIMUR,48110,NGAWI,48271,WIDODAREN,13695,24553,38248
42385,JAWA TIMUR,42386,PACITAN,42474,ARJOSARI,15613,6540,22153
42385,JAWA TIMUR,42386,PACITAN,42502,BANDAR,15693,8153,23846
42385,JAWA TIMUR,42386,PACITAN,42387,DONOROJO,9123,11467,20590
42385,JAWA TIMUR,42386,PACITAN,42454,KEBONAGUNG,19865,7227,27092
42385,JAWA TIMUR,42386,PACITAN,42492,NAWANGAN,14975,10887,25862
42385,JAWA TIMUR,42386,PACITAN,42540,NGADIROJO,17139,9779,26918
42385,JAWA TIMUR,42386,PACITAN,42428,PACITAN,34407,9916,44323
42385,JAWA TIMUR,42386,PACITAN,42400,PRINGKUKU,12521,6407,18928
42385,JAWA TIMUR,42386,PACITAN,42414,PUNUNG,13649,7683,21332
42385,JAWA TIMUR,42386,PACITAN,42559,SUDIMORO,8628,9057,17685
42385,JAWA TIMUR,42386,PACITAN,42511,TEGALOMBO,17277,8915,26192
42385,JAWA TIMUR,42386,PACITAN,42523,TULAKAN,26475,16301,42776
42385,JAWA TIMUR,50532,PAMEKASAN,50700,BATUMARMAR,53230,11809,65039
42385,JAWA TIMUR,50532,PAMEKASAN,50574,GALIS,9895,6541,16436
42385,JAWA TIMUR,50532,PAMEKASAN,50714,KADUR,13490,10157,23647
42385,JAWA TIMUR,50532,PAMEKASAN,50659,LARANGAN,16715,11508,28223
42385,JAWA TIMUR,50532,PAMEKASAN,50551,PADEMAWU,31448,15022,46470
42385,JAWA TIMUR,50532,PAMEKASAN,50674,PAKONG,13628,5560,19188
42385,JAWA TIMUR,50532,PAMEKASAN,50585,PAMEKASAN,39331,11323,50654
42385,JAWA TIMUR,50532,PAMEKASAN,50725,PASEAN,23833,9982,33815
42385,JAWA TIMUR,50532,PAMEKASAN,50645,PEGANTENAN,35708,9944,45652
42385,JAWA TIMUR,50532,PAMEKASAN,50604,PROPPO,41532,9576,51108
42385,JAWA TIMUR,50532,PAMEKASAN,50533,TLANAKAN,19961,11977,31938
42385,JAWA TIMUR,50532,PAMEKASAN,50687,WARU,36813,6240,43053
42385,JAWA TIMUR,45916,PASURUAN,46126,BANGIL,29431,15061,44492
42385,JAWA TIMUR,45916,PASURUAN,46111,BEJI,28699,17027,45726
42385,JAWA TIMUR,45916,PASURUAN,46095,GEMPOL,37994,30592,68586
42385,JAWA TIMUR,45916,PASURUAN,46196,GONDANGWETAN,16352,11209,27561
42385,JAWA TIMUR,45916,PASURUAN,46236,GRATI,20400,20937,41337
42385,JAWA TIMUR,45916,PASURUAN,45983,KEJAYAN,21130,11602,32732
42385,JAWA TIMUR,45916,PASURUAN,46160,KRATON,30111,12847,42958
42385,JAWA TIMUR,45916,PASURUAN,46268,LEKOK,12858,18699,31557
42385,JAWA TIMUR,45916,PASURUAN,45952,LUMBANG,10138,8409,18547
42385,JAWA TIMUR,45916,PASURUAN,46252,NGULING,16286,12333,28619
42385,JAWA TIMUR,45916,PASURUAN,46076,PANDAAN,33808,26168,59976
42385,JAWA TIMUR,45916,PASURUAN,45965,PASREPAN,12840,10827,23667
42385,JAWA TIMUR,45916,PASURUAN,46186,POHJENTREK,10427,5609,16036
42385,JAWA TIMUR,45916,PASURUAN,46061,PRIGEN,22219,26322,48541
42385,JAWA TIMUR,45916,PASURUAN,45917,PURWODADI,21152,15956,37108
42385,JAWA TIMUR,45916,PASURUAN,46025,PURWOSARI,25666,19722,45388
42385,JAWA TIMUR,45916,PASURUAN,45944,PUSPO,7716,5711,13427
42385,JAWA TIMUR,45916,PASURUAN,46280,REJOSO,14175,10838,25013
42385,JAWA TIMUR,45916,PASURUAN,46142,REMBANG,19868,11758,31626
42385,JAWA TIMUR,45916,PASURUAN,46041,SUKOREJO,26040,17657,43697
42385,JAWA TIMUR,45916,PASURUAN,46297,TOSARI,7430,4742,12172
42385,JAWA TIMUR,45916,PASURUAN,45931,TUTUR,17947,12602,30549
42385,JAWA TIMUR,45916,PASURUAN,46217,WINONGAN,12879,9634,22513
42385,JAWA TIMUR,45916,PASURUAN,46009,WONOREJO,19159,8668,27827
42385,JAWA TIMUR,42570,PONOROGO,42813,BABADAN,14499,24784,39283
42385,JAWA TIMUR,42570,PONOROGO,42771,BADEGAN,8115,9204,17319
42385,JAWA TIMUR,42570,PONOROGO,42733,BALONG,14788,11562,26350
42385,JAWA TIMUR,42570,PONOROGO,42606,BUNGKAL,11809,10734,22543
42385,JAWA TIMUR,42570,PONOROGO,42876,JAMBON,11309,12064,23373
42385,JAWA TIMUR,42570,PONOROGO,42849,JENANGAN,16777,16221,32998
42385,JAWA TIMUR,42570,PONOROGO,42699,JETIS,9724,8563,18287
42385,JAWA TIMUR,42570,PONOROGO,42754,KAUMAN,12564,12829,25393
42385,JAWA TIMUR,42570,PONOROGO,42683,MLARAK,12714,7859,20573
42385,JAWA TIMUR,42570,PONOROGO,42867,NGEBEL,5685,6621,12306
42385,JAWA TIMUR,42570,PONOROGO,42594,NGRAYUN,12722,21510,34232
42385,JAWA TIMUR,42570,PONOROGO,42829,PONOROGO,18820,25393,44213
42385,JAWA TIMUR,42570,PONOROGO,42890,PUDAK,2970,2712,5682
42385,JAWA TIMUR,42570,PONOROGO,42664,PULUNG,12483,17518,30001
42385,JAWA TIMUR,42570,PONOROGO,42626,SAMBIT,9681,11922,21603
42385,JAWA TIMUR,42570,PONOROGO,42782,SAMPUNG,10632,12323,22955
42385,JAWA TIMUR,42570,PONOROGO,42642,SAWOO,15828,16810,32638
42385,JAWA TIMUR,42570,PONOROGO,42714,SIMAN,12521,12897,25418
42385,JAWA TIMUR,42570,PONOROGO,42571,SLAHUNG,14996,14666,29662
42385,JAWA TIMUR,42570,PONOROGO,42657,SOOKO,6203,8336,14539
42385,JAWA TIMUR,42570,PONOROGO,42794,SUKOREJO,15545,16161,31706
42385,JAWA TIMUR,45561,PROBOLINGGO,45593,BANTARAN,11224,7097,18321
42385,JAWA TIMUR,45561,PROBOLINGGO,45615,BANYUANYAR,12941,12270,25211
42385,JAWA TIMUR,45561,PROBOLINGGO,45735,BESUK,12430,12826,25256
42385,JAWA TIMUR,45561,PROBOLINGGO,45836,DRINGU,11281,19047,30328
42385,JAWA TIMUR,45561,PROBOLINGGO,45662,GADING,11859,14885,26744
42385,JAWA TIMUR,45561,PROBOLINGGO,45822,GENDING,10421,10308,20729
42385,JAWA TIMUR,45561,PROBOLINGGO,45700,KOTAANYAR,9805,11674,21479
42385,JAWA TIMUR,45561,PROBOLINGGO,45753,KRAKSAAN,13405,20287,33692
42385,JAWA TIMUR,45561,PROBOLINGGO,45772,KREJENGAN,9235,12275,21510
42385,JAWA TIMUR,45561,PROBOLINGGO,45647,KRUCIL,10175,10798,20973
42385,JAWA TIMUR,45561,PROBOLINGGO,45585,KURIPAN,5210,6966,12176
42385,JAWA TIMUR,45561,PROBOLINGGO,45604,LECES,15118,12018,27136
42385,JAWA TIMUR,45561,PROBOLINGGO,45905,LUMBANG,6545,9452,15997
42385,JAWA TIMUR,45561,PROBOLINGGO,45803,MARON,17383,14500,31883
42385,JAWA TIMUR,45561,PROBOLINGGO,45714,PAITON,21951,16036,37987
42385,JAWA TIMUR,45561,PROBOLINGGO,45790,PAJARAKAN,9262,9201,18463
42385,JAWA TIMUR,45561,PROBOLINGGO,45682,PAKUNIRAN,10794,14036,24830
42385,JAWA TIMUR,45561,PROBOLINGGO,45562,SUKAPURA,5871,6401,12272
42385,JAWA TIMUR,45561,PROBOLINGGO,45575,SUMBER,8015,7288,15303
42385,JAWA TIMUR,45561,PROBOLINGGO,45864,SUMBERASIH,19163,13248,32411
42385,JAWA TIMUR,45561,PROBOLINGGO,45851,TEGALSIWALAN,9677,7648,17325
42385,JAWA TIMUR,45561,PROBOLINGGO,45630,TIRIS,11580,17293,28873
42385,JAWA TIMUR,45561,PROBOLINGGO,45890,TONGAS,16535,16712,33247
42385,JAWA TIMUR,45561,PROBOLINGGO,45878,WONOMERTO,10223,7428,17651
42385,JAWA TIMUR,50331,SAMPANG,50458,BANYUATES,0,0,0
42385,JAWA TIMUR,50331,SAMPANG,50377,CAMPLONG,0,0,0
42385,JAWA TIMUR,50331,SAMPANG,50432,JRENGIK,0,0,0
42385,JAWA TIMUR,50331,SAMPANG,50524,KARANGPENANG,0,0,0
42385,JAWA TIMUR,50331,SAMPANG,50413,KEDUNGDUNG,0,0,0
42385,JAWA TIMUR,50331,SAMPANG,50502,KETAPANG,0,0,0
42385,JAWA TIMUR,50331,SAMPANG,50392,OMBEN,0,0,0
42385,JAWA TIMUR,50331,SAMPANG,50517,PANGARENGAN,0,0,0
42385,JAWA TIMUR,50331,SAMPANG,50479,ROBATAL,31627,7634,39261
42385,JAWA TIMUR,50331,SAMPANG,50358,SAMPANG,0,0,0
42385,JAWA TIMUR,50331,SAMPANG,50489,SOKOBANAH,0,0,0
42385,JAWA TIMUR,50331,SAMPANG,50332,SRESEH,0,0,0
42385,JAWA TIMUR,50331,SAMPANG,50447,TAMBELANGAN,0,0,0
42385,JAWA TIMUR,50331,SAMPANG,50345,TORJUN,0,0,0
42385,JAWA TIMUR,46306,SIDOARJO,46545,BALONGBENDO,18062,23003,41065
42385,JAWA TIMUR,46306,SIDOARJO,46611,BUDURAN,23782,21745,45527
42385,JAWA TIMUR,46306,SIDOARJO,46425,CANDI,35008,37657,72665
42385,JAWA TIMUR,46306,SIDOARJO,46627,GEDANGAN,28290,29835,58125
42385,JAWA TIMUR,46306,SIDOARJO,46389,JABON,15516,12799,28315
42385,JAWA TIMUR,46306,SIDOARJO,46349,KREMBUNG,17793,20500,38293
42385,JAWA TIMUR,46306,SIDOARJO,46522,KRIAN,26213,36760,62973
42385,JAWA TIMUR,46306,SIDOARJO,46369,PORONG,15734,21316,37050
42385,JAWA TIMUR,46306,SIDOARJO,46328,PRAMBON,17740,25679,43419
42385,JAWA TIMUR,46306,SIDOARJO,46643,SEDATI,21110,22040,43150
42385,JAWA TIMUR,46306,SIDOARJO,46450,SIDOARJO,46124,54639,100763
42385,JAWA TIMUR,46306,SIDOARJO,46591,SUKODONO,24501,31668,56169
42385,JAWA TIMUR,46306,SIDOARJO,46566,TAMAN,43812,59882,103694
42385,JAWA TIMUR,46306,SIDOARJO,46405,TANGGULANGIN,23035,23700,46735
42385,JAWA TIMUR,46306,SIDOARJO,46307,TARIK,19530,19176,38706
42385,JAWA TIMUR,46306,SIDOARJO,46475,TULANGAN,22890,28169,51059
42385,JAWA TIMUR,46306,SIDOARJO,46660,WARU,44987,59242,104229
42385,JAWA TIMUR,46306,SIDOARJO,46498,WONOAYU,20766,22916,43682
42385,JAWA TIMUR,45407,SITUBONDO,45500,ARJASA,13148,9037,22185
42385,JAWA TIMUR,45407,SITUBONDO,45518,ASEMBAGUS,15018,10782,25800
42385,JAWA TIMUR,45407,SITUBONDO,45545,BANYUGLUGUR,7618,5393,13011
42385,JAWA TIMUR,45407,SITUBONDO,45529,BANYUPUTIH,10680,14886,25566
42385,JAWA TIMUR,45407,SITUBONDO,45417,BESUKI,22138,12514,34652
42385,JAWA TIMUR,45407,SITUBONDO,45553,BUNGATAN,8803,6113,14916
42385,JAWA TIMUR,45407,SITUBONDO,45509,JANGKAR,12085,7884,19969
42385,JAWA TIMUR,45407,SITUBONDO,45408,JATIBANTENG,8429,4226,12655
42385,JAWA TIMUR,45407,SITUBONDO,45489,KAPONGAN,12582,9648,22230
42385,JAWA TIMUR,45407,SITUBONDO,45445,KENDIT,10679,6654,17333
42385,JAWA TIMUR,45407,SITUBONDO,45482,MANGARAN,10536,8397,18933
42385,JAWA TIMUR,45407,SITUBONDO,45437,MLANDINGAN,8914,4726,13640
42385,JAWA TIMUR,45407,SITUBONDO,45453,PANARUKAN,17703,13201,30904
42385,JAWA TIMUR,45407,SITUBONDO,45469,PANJI,24436,17923,42359
42385,JAWA TIMUR,45407,SITUBONDO,45462,SITUBONDO,15940,12228,28168
42385,JAWA TIMUR,45407,SITUBONDO,45428,SUBOH,11406,4822,16228
42385,JAWA TIMUR,45407,SITUBONDO,45535,SUMBERMALANG,9919,4584,14503
42385,JAWA TIMUR,50735,SUMENEP,50891,AMBUNTEN,11912,10781,22693
42385,JAWA TIMUR,50735,SUMENEP,51047,ARJASA,27270,10303,37573
42385,JAWA TIMUR,50735,SUMENEP,50946,BATANG BATANG,13332,14372,27704
42385,JAWA TIMUR,50735,SUMENEP,50963,BATU PUTIH,11438,10733,22171
42385,JAWA TIMUR,50735,SUMENEP,51077,BATUAN,3578,2861,6439
42385,JAWA TIMUR,50735,SUMENEP,50782,BLUTO,15715,11357,27072
42385,JAWA TIMUR,50735,SUMENEP,50918,DASUK,9241,6717,15958
42385,JAWA TIMUR,50735,SUMENEP,50978,DUNGKEK,9106,9155,18261
42385,JAWA TIMUR,50735,SUMENEP,50861,GANDING,9872,8476,18348
42385,JAWA TIMUR,50735,SUMENEP,50994,GAPURA,8009,12136,20145
42385,JAWA TIMUR,50735,SUMENEP,51012,GAYAM,12430,5260,17690
42385,JAWA TIMUR,50735,SUMENEP,50839,GILI GINTING,5115,5188,10303
42385,JAWA TIMUR,50735,SUMENEP,50753,KALIANGET,10848,10623,21471
42385,JAWA TIMUR,50735,SUMENEP,51085,KANGAYAN,8215,2822,11037
42385,JAWA TIMUR,50735,SUMENEP,50736,KOTA SUMENEP,25784,14635,40419
42385,JAWA TIMUR,50735,SUMENEP,50818,LENTENG,15212,18664,33876
42385,JAWA TIMUR,50735,SUMENEP,50761,MANDING,8478,6652,15130
42385,JAWA TIMUR,50735,SUMENEP,51042,MASALEMBU,3849,5462,9311
42385,JAWA TIMUR,50735,SUMENEP,51023,NONGGUNONG,4252,3166,7418
42385,JAWA TIMUR,50735,SUMENEP,50907,PASONGSONGAN,14923,11451,26374
42385,JAWA TIMUR,50735,SUMENEP,50876,PRAGAAN,27194,15251,42445
42385,JAWA TIMUR,50735,SUMENEP,50934,RUBARU,11981,8830,20811
42385,JAWA TIMUR,50735,SUMENEP,51067,SAPEKEN,15691,5899,21590
42385,JAWA TIMUR,50735,SUMENEP,50803,SARONGGI,10329,10601,20930
42385,JAWA TIMUR,50735,SUMENEP,50773,TALANGO,7983,11287,19270
42385,JAWA TIMUR,42897,TRENGGALEK,43000,BENDUNGAN,5583,9649,15232
42385,JAWA TIMUR,42897,TRENGGALEK,42939,DONGKO,7825,25603,33428
42385,JAWA TIMUR,42897,TRENGGALEK,43046,DURENAN,11930,17569,29499
42385,JAWA TIMUR,42897,TRENGGALEK,43009,GANDUSARI,11734,19249,30983
42385,JAWA TIMUR,42897,TRENGGALEK,42979,KAMPAK,5902,16058,21960
42385,JAWA TIMUR,42897,TRENGGALEK,42966,KARANGAN,12466,15590,28056
42385,JAWA TIMUR,42897,TRENGGALEK,42916,MUNJUNGAN,7575,22342,29917
42385,JAWA TIMUR,42897,TRENGGALEK,42898,PANGGUL,11137,28641,39778
42385,JAWA TIMUR,42897,TRENGGALEK,43035,POGALAN,11172,18201,29373
42385,JAWA TIMUR,42897,TRENGGALEK,42928,PULE,10538,19744,30282
42385,JAWA TIMUR,42897,TRENGGALEK,43061,SURUH,5876,9368,15244
42385,JAWA TIMUR,42897,TRENGGALEK,43021,TRENGGALEK,17039,21062,38101
42385,JAWA TIMUR,42897,TRENGGALEK,42950,TUGU,12137,14949,27086
42385,JAWA TIMUR,42897,TRENGGALEK,42987,WATULIMO,10066,29747,39813
42385,JAWA TIMUR,48805,TUBAN,48850,BANCAR,11226,22021,33247
42385,JAWA TIMUR,48805,TUBAN,48835,BANGILAN,9935,13510,23445
42385,JAWA TIMUR,48805,TUBAN,49142,GRABAGAN,6433,13598,20031
42385,JAWA TIMUR,48805,TUBAN,48816,JATIROGO,10642,20652,31294
42385,JAWA TIMUR,48805,TUBAN,48995,JENU,11668,16921,28589
42385,JAWA TIMUR,48805,TUBAN,48806,KENDURUAN,4949,10063,15012
42385,JAWA TIMUR,48805,TUBAN,48920,KEREK,12767,23355,36122
42385,JAWA TIMUR,48805,TUBAN,49013,MERAKURAK,14429,16454,30883
42385,JAWA TIMUR,48805,TUBAN,48957,MONTONG,11785,16656,28441
42385,JAWA TIMUR,48805,TUBAN,49105,PALANG,19411,24792,44203
42385,JAWA TIMUR,48805,TUBAN,48938,PARENGAN,14020,16089,30109
42385,JAWA TIMUR,48805,TUBAN,49086,PLUMPANG,17267,23969,41236
42385,JAWA TIMUR,48805,TUBAN,49033,RENGEL,16262,15994,32256
42385,JAWA TIMUR,48805,TUBAN,49050,SEMANDING,25771,32340,58111
42385,JAWA TIMUR,48805,TUBAN,48875,SENORI,9081,11976,21057
42385,JAWA TIMUR,48805,TUBAN,48907,SINGGAHAN,9301,12478,21779
42385,JAWA TIMUR,48805,TUBAN,48971,SOKO,21288,25559,46847
42385,JAWA TIMUR,48805,TUBAN,48888,TAMBAKBOYO,8731,13744,22475
42385,JAWA TIMUR,48805,TUBAN,49068,TUBAN,22366,26462,48828
42385,JAWA TIMUR,48805,TUBAN,49125,WIDANG,10566,16566,27132
42385,JAWA TIMUR,43069,TULUNGAGUNG,43313,BANDUNG,9980,17779,27759
42385,JAWA TIMUR,43069,TULUNGAGUNG,43292,BESUKI,7599,13921,21520
42385,JAWA TIMUR,43069,TULUNGAGUNG,43085,BOYOLANGU,16835,30131,46966
42385,JAWA TIMUR,43069,TULUNGAGUNG,43303,CAMPURDARAT,9374,24051,33425
42385,JAWA TIMUR,43069,TULUNGAGUNG,43189,GONDANG,14908,19048,33956
42385,JAWA TIMUR,43069,TULUNGAGUNG,43274,KALIDAWIR,11955,28310,40265
42385,JAWA TIMUR,43069,TULUNGAGUNG,43175,KARANGREJO,9904,14804,24708
42385,JAWA TIMUR,43069,TULUNGAGUNG,43137,KAUMAN,11950,18955,30905
42385,JAWA TIMUR,43069,TULUNGAGUNG,43103,KEDUNGWARU,16708,35162,51870
42385,JAWA TIMUR,43069,TULUNGAGUNG,43123,NGANTRU,8797,23505,32302
42385,JAWA TIMUR,43069,TULUNGAGUNG,43228,NGUNUT,13040,32010,45050
42385,JAWA TIMUR,43069,TULUNGAGUNG,43151,PAGERWOJO,8214,10649,18863
42385,JAWA TIMUR,43069,TULUNGAGUNG,43332,PAKEL,11449,19477,30926
42385,JAWA TIMUR,43069,TULUNGAGUNG,43247,PUCANGLABAN,4458,9089,13547
42385,JAWA TIMUR,43069,TULUNGAGUNG,43257,REJOTANGAN,14204,28079,42283
42385,JAWA TIMUR,43069,TULUNGAGUNG,43163,SENDANG,10865,16273,27138
42385,JAWA TIMUR,43069,TULUNGAGUNG,43210,SUMBERGEMPOL,11481,26470,37951
42385,JAWA TIMUR,43069,TULUNGAGUNG,43352,TANGGUNGGUNUNG,4552,10578,15130
42385,JAWA TIMUR,43069,TULUNGAGUNG,43070,TULUNGAGUNG,14699,23191,37890
58285,KALIMANTAN BARAT,59557,BENGKAYANG,59585,BENGKAYANG,2540,10584,13124
58285,KALIMANTAN BARAT,59557,BENGKAYANG,59652,CAPKALA,793,3111,3904
58285,KALIMANTAN BARAT,59557,BENGKAYANG,59605,JAGOI BABANG,803,3616,4419
58285,KALIMANTAN BARAT,59557,BENGKAYANG,59572,LEDO,1271,5846,7117
58285,KALIMANTAN BARAT,59557,BENGKAYANG,59685,LEMBAH BAWANG,501,2366,2867
58285,KALIMANTAN BARAT,59557,BENGKAYANG,59668,LUMAR,462,3383,3845
58285,KALIMANTAN BARAT,59557,BENGKAYANG,59612,MONTERADO,3363,10207,13570
58285,KALIMANTAN BARAT,59557,BENGKAYANG,59564,SAMALANTAN,1606,9796,11402
58285,KALIMANTAN BARAT,59557,BENGKAYANG,59599,SANGGAU LEDO,2242,4272,6514
58285,KALIMANTAN BARAT,59557,BENGKAYANG,59592,SELUAS,2211,6125,8336
58285,KALIMANTAN BARAT,59557,BENGKAYANG,59659,SIDING,363,2727,3090
58285,KALIMANTAN BARAT,59557,BENGKAYANG,59674,SUNGAI BETUNG,508,4268,4776
58285,KALIMANTAN BARAT,59557,BENGKAYANG,59558,SUNGAI RAYA,4666,5208,9874
58285,KALIMANTAN BARAT,59557,BENGKAYANG,59679,SUNGAI RAYA KEPULAUAN,5406,5192,10598
58285,KALIMANTAN BARAT,59557,BENGKAYANG,59643,SUTI SEMARANG,617,2562,3179
58285,KALIMANTAN BARAT,59557,BENGKAYANG,59624,TERIAK,850,7423,8273
58285,KALIMANTAN BARAT,59557,BENGKAYANG,59694,TUJUH BELAS,2524,4740,7264
58285,KALIMANTAN BARAT,59320,KAPUAS HULU,59454,BADAU,984,2441,3425
58285,KALIMANTAN BARAT,59320,KAPUAS HULU,59437,BATANG LUPAR,635,2214,2849
58285,KALIMANTAN BARAT,59320,KAPUAS HULU,59336,BIKA,251,2294,2545
58285,KALIMANTAN BARAT,59320,KAPUAS HULU,59517,BOYAN TANJUNG,2880,3100,5980
58285,KALIMANTAN BARAT,59320,KAPUAS HULU,59366,BUNUT HILIR,2094,3057,5151
58285,KALIMANTAN BARAT,59320,KAPUAS HULU,59375,BUNUT HULU,4033,3440,7473
58285,KALIMANTAN BARAT,59320,KAPUAS HULU,59345,EMBALOH HILIR,727,2298,3025
58285,KALIMANTAN BARAT,59320,KAPUAS HULU,59355,EMBALOH HULU,220,2492,2712
58285,KALIMANTAN BARAT,59320,KAPUAS HULU,59447,EMPANANG,201,1940,2141
58285,KALIMANTAN BARAT,59320,KAPUAS HULU,59392,HULU GURUNG,5534,2626,8160
58285,KALIMANTAN BARAT,59320,KAPUAS HULU,59383,JONGKONG,3214,2734,5948
58285,KALIMANTAN BARAT,59320,KAPUAS HULU,59505,KALIS,1659,6384,8043
58285,KALIMANTAN BARAT,59320,KAPUAS HULU,59526,MENTEBAH,1715,3057,4772
58285,KALIMANTAN BARAT,59320,KAPUAS HULU,59532,PENGKADAN,2619,2253,4872
58285,KALIMANTAN BARAT,59320,KAPUAS HULU,59551,PURING KENCANA,104,1236,1340
58285,KALIMANTAN BARAT,59320,KAPUAS HULU,59488,PUTUSSIBAU SELATAN,4301,7411,11712
58285,KALIMANTAN BARAT,59320,KAPUAS HULU,59321,PUTUSSIBAU UTARA,4717,9033,13750
58285,KALIMANTAN BARAT,59320,KAPUAS HULU,59425,SEBERUANG,436,6004,6440
58285,KALIMANTAN BARAT,59320,KAPUAS HULU,59402,SELIMBAU,2336,4955,7291
58285,KALIMANTAN BARAT,59320,KAPUAS HULU,59416,SEMITAU,878,3995,4873
58285,KALIMANTAN BARAT,59320,KAPUAS HULU,59464,SILAT HILIR,2468,7182,9650
58285,KALIMANTAN BARAT,59320,KAPUAS HULU,59476,SILAT HULU,2031,4817,6848
58285,KALIMANTAN BARAT,59320,KAPUAS HULU,59541,SUHAID,1309,3371,4680
58285,KALIMANTAN BARAT,60134,KAYONG UTARA,83729,KEPULAUAN KARIMATA,632,886,1518
58285,KALIMANTAN BARAT,60134,KAYONG UTARA,60167,PULAU MAYA,3566,2426,5992
58285,KALIMANTAN BARAT,60134,KAYONG UTARA,60176,SEPONTI,2559,3082,5641
58285,KALIMANTAN BARAT,60134,KAYONG UTARA,60146,SIMPANG HILIR,7403,6403,13806
58285,KALIMANTAN BARAT,60134,KAYONG UTARA,60135,SUKADANA,7391,4448,11839
58285,KALIMANTAN BARAT,60134,KAYONG UTARA,60159,TELUK BATANG,4752,3424,8176
58285,KALIMANTAN BARAT,58749,KETAPANG,58977,AIR UPAS,1968,7882,9850
58285,KALIMANTAN BARAT,58749,KETAPANG,58931,BENUA KAYONG,14965,4811,19776
58285,KALIMANTAN BARAT,58749,KETAPANG,58943,DELTA PAWAN,20416,14981,35397
58285,KALIMANTAN BARAT,58749,KETAPANG,58987,HULU SUNGAI,516,6185,6701
58285,KALIMANTAN BARAT,58749,KETAPANG,58911,JELAI HULU,1634,8185,9819
58285,KALIMANTAN BARAT,58749,KETAPANG,58787,KENDAWANGAN,5207,12565,17772
58285,KALIMANTAN BARAT,58749,KETAPANG,58767,MANIS MATA,4662,10735,15397
58285,KALIMANTAN BARAT,58749,KETAPANG,58756,MARAU,1279,6723,8002
58285,KALIMANTAN BARAT,58749,KETAPANG,58873,MATAN HILIR SELATAN,8604,5894,14498
58285,KALIMANTAN BARAT,58749,KETAPANG,58750,MATAN HILIR UTARA,3674,3535,7209
58285,KALIMANTAN BARAT,58749,KETAPANG,58953,MUARA PAWAN,4103,3009,7112
58285,KALIMANTAN BARAT,58749,KETAPANG,58854,NANGA TAYAP,6038,10097,16135
58285,KALIMANTAN BARAT,58749,KETAPANG,59000,PEMAHAN,1152,1356,2508
58285,KALIMANTAN BARAT,58749,KETAPANG,58807,SANDAI,5488,8770,14258
58285,KALIMANTAN BARAT,58749,KETAPANG,58962,SIMPANG DUA,429,4856,5285
58285,KALIMANTAN BARAT,58749,KETAPANG,58839,SIMPANG HULU,1491,17594,19085
58285,KALIMANTAN BARAT,58749,KETAPANG,58968,SINGKUP,1442,2336,3778
58285,KALIMANTAN BARAT,58749,KETAPANG,58820,SUNGAI LAUR,3178,7265,10443
58285,KALIMANTAN BARAT,58749,KETAPANG,59006,SUNGAI MELAYU RAYAK,2340,4687,7027
58285,KALIMANTAN BARAT,58749,KETAPANG,58885,TUMBANG TITI,3304,8678,11982
58285,KALIMANTAN BARAT,60183,KOTA PONTIANAK,60198,PONTIANAK BARAT,45640,22915,68555
58285,KALIMANTAN BARAT,60183,KOTA PONTIANAK,60208,PONTIANAK KOTA,37525,25009,62534
58285,KALIMANTAN BARAT,60183,KOTA PONTIANAK,60184,PONTIANAK SELATAN,19200,27249,46449
58285,KALIMANTAN BARAT,60183,KOTA PONTIANAK,60214,PONTIANAK TENGGARA,14293,9343,23636
58285,KALIMANTAN BARAT,60183,KOTA PONTIANAK,60190,PONTIANAK TIMUR,31481,12740,44221
58285,KALIMANTAN BARAT,60183,KOTA PONTIANAK,60203,PONTIANAK UTARA,34513,29021,63534
58285,KALIMANTAN BARAT,60223,KOTA SINGKAWANG,60231,SINGKAWANG BARAT,6243,15843,22086
58285,KALIMANTAN BARAT,60223,KOTA SINGKAWANG,60250,SINGKAWANG SELATAN,6107,14026,20133
58285,KALIMANTAN BARAT,60223,KOTA SINGKAWANG,60224,SINGKAWANG TENGAH,17577,12370,29947
58285,KALIMANTAN BARAT,60223,KOTA SINGKAWANG,60236,SINGKAWANG TIMUR,2089,7834,9923
58285,KALIMANTAN BARAT,60223,KOTA SINGKAWANG,60242,SINGKAWANG UTARA,7189,5517,12706
58285,KALIMANTAN BARAT,60255,KUBU RAYA,60301,BATU AMPAR,9131,6180,15311
58285,KALIMANTAN BARAT,60255,KUBU RAYA,60271,KUALA MANDOR B,10661,3869,14530
58285,KALIMANTAN BARAT,60255,KUBU RAYA,60316,KUBU,10737,8158,18895
58285,KALIMANTAN BARAT,60255,KUBU RAYA,60336,RASAU JAYA,6735,6637,13372
58285,KALIMANTAN BARAT,60255,KUBU RAYA,60277,SUNGAI AMBAWANG,24972,16621,41593
58285,KALIMANTAN BARAT,60255,KUBU RAYA,60358,SUNGAI KAKAP,35781,18500,54281
58285,KALIMANTAN BARAT,60255,KUBU RAYA,60256,SUNGAI RAYA,57329,47012,104341
58285,KALIMANTAN BARAT,60255,KUBU RAYA,60343,TELUK PAKEDAI,5388,3201,8589
58285,KALIMANTAN BARAT,60255,KUBU RAYA,60291,TERENTANG,2689,2688,5377
58285,KALIMANTAN BARAT,59699,LANDAK,59765,AIR BESAR,2864,13136,16000
58285,KALIMANTAN BARAT,59699,LANDAK,59853,BANYUKE HULU,781,7877,8658
58285,KALIMANTAN BARAT,59699,LANDAK,59839,JELIMPO,2358,15321,17679
58285,KALIMANTAN BARAT,59699,LANDAK,59821,KUALA BEHE,2280,8409,10689
58285,KALIMANTAN BARAT,59699,LANDAK,59747,MANDOR,2831,14278,17109
58285,KALIMANTAN BARAT,59699,LANDAK,59720,MEMPAWAH HULU,1932,21359,23291
58285,KALIMANTAN BARAT,59699,LANDAK,59738,MENJALIN,1025,10957,11982
58285,KALIMANTAN BARAT,59699,LANDAK,59782,MENYUKE,2869,16176,19045
58285,KALIMANTAN BARAT,59699,LANDAK,59814,MERANTI,1057,5511,6568
58285,KALIMANTAN BARAT,59699,LANDAK,59700,NGABANG,9248,31249,40497
58285,KALIMANTAN BARAT,59699,LANDAK,59833,SEBANGKI,5394,6104,11498
58285,KALIMANTAN BARAT,59699,LANDAK,59799,SENGAH TEMILA,3991,35825,39816
58285,KALIMANTAN BARAT,59699,LANDAK,59861,SOMPAK,993,9408,10401
58285,KALIMANTAN BARAT,59953,MELAWI,59954,BELIMBING,4538,9771,14309
58285,KALIMANTAN BARAT,59953,MELAWI,60081,BELIMBING HULU,2220,4734,6954
58285,KALIMANTAN BARAT,59953,MELAWI,59990,ELLA HILIR,4788,6729,11517
58285,KALIMANTAN BARAT,59953,MELAWI,60010,MENUKUNG,3162,10427,13589
58285,KALIMANTAN BARAT,59953,MELAWI,59972,NANGA PINOH,15066,11774,26840
58285,KALIMANTAN BARAT,59953,MELAWI,60110,PINOH SELATAN,3435,4892,8327
58285,KALIMANTAN BARAT,59953,MELAWI,60090,PINOH UTARA,5578,5918,11496
58285,KALIMANTAN BARAT,59953,MELAWI,60030,SAYAN,5289,7942,13231
58285,KALIMANTAN BARAT,59953,MELAWI,60062,SOKAN,6034,6901,12935
58285,KALIMANTAN BARAT,59953,MELAWI,60049,TANAH PINOH,6332,4771,11103
58285,KALIMANTAN BARAT,59953,MELAWI,60123,TANAH PINOH BARAT,2908,7371,10279
58285,KALIMANTAN BARAT,58490,PONTIANAK,58545,ANJONGAN,4912,3985,8897
58285,KALIMANTAN BARAT,58490,PONTIANAK,58491,MEMPAWAH HILIR,13070,5145,18215
58285,KALIMANTAN BARAT,58490,PONTIANAK,58558,MEMPAWAH TIMUR,10554,2530,13084
58285,KALIMANTAN BARAT,58490,PONTIANAK,58551,SADANIANG,503,5130,5633
58285,KALIMANTAN BARAT,58490,PONTIANAK,58538,SEGEDONG,6245,3888,10133
58285,KALIMANTAN BARAT,58490,PONTIANAK,58519,SIANTAN,12876,8091,20967
58285,KALIMANTAN BARAT,58490,PONTIANAK,58525,SUNGAI KUNYIT,7486,4056,11542
58285,KALIMANTAN BARAT,58490,PONTIANAK,58509,SUNGAI PINYUH,15483,9330,24813
58285,KALIMANTAN BARAT,58490,PONTIANAK,58500,TOHO,2366,7692,10058
58285,KALIMANTAN BARAT,58286,SAMBAS,58423,GALING,4933,7066,11999
58285,KALIMANTAN BARAT,58286,SAMBAS,58331,JAWAI,8663,9338,18001
58285,KALIMANTAN BARAT,58286,SAMBAS,58461,JAWAI SELATAN,3803,5271,9074
58285,KALIMANTAN BARAT,58286,SAMBAS,58396,PALOH,5078,7186,12264
58285,KALIMANTAN BARAT,58286,SAMBAS,58367,PEMANGKAT,7989,14105,22094
58285,KALIMANTAN BARAT,58286,SAMBAS,58448,SAJAD,1764,3262,5026
58285,KALIMANTAN BARAT,58286,SAMBAS,58405,SAJINGAN BESAR,549,5406,5955
58285,KALIMANTAN BARAT,58286,SAMBAS,58479,SALATIGA,3294,4748,8042
58285,KALIMANTAN BARAT,58286,SAMBAS,58287,SAMBAS,12143,12524,24667
58285,KALIMANTAN BARAT,58286,SAMBAS,58453,SEBAWI,3584,4732,8316
58285,KALIMANTAN BARAT,58286,SAMBAS,58373,SEJANGKUNG,4745,6427,11172
58285,KALIMANTAN BARAT,58286,SAMBAS,58386,SELAKAU,6291,8821,15112
58285,KALIMANTAN BARAT,58286,SAMBAS,58485,SELAKAU TIMUR,2315,2931,5246
58285,KALIMANTAN BARAT,58286,SAMBAS,58442,SEMPARUK,6175,6990,13165
58285,KALIMANTAN BARAT,58286,SAMBAS,58411,SUBAH,3498,7953,11451
58285,KALIMANTAN BARAT,58286,SAMBAS,58471,TANGARAN,6152,4870,11022
58285,KALIMANTAN BARAT,58286,SAMBAS,58343,TEBAS,12993,21819,34812
58285,KALIMANTAN BARAT,58286,SAMBAS,58434,TEKARANG,3597,3940,7537
58285,KALIMANTAN BARAT,58286,SAMBAS,58306,TELUK KERAMAT,15253,17614,32867
58285,KALIMANTAN BARAT,58567,SANGGAU,58703,BALAI,1869,12864,14733
58285,KALIMANTAN BARAT,58567,SANGGAU,58631,BEDUAI,1385,5339,6724
58285,KALIMANTAN BARAT,58567,SANGGAU,58621,BONTI,3037,10728,13765
58285,KALIMANTAN BARAT,58567,SANGGAU,58743,ENTIKONG,1853,7297,9150
58285,KALIMANTAN BARAT,58567,SANGGAU,58609,JANGKANG,2209,14450,16659
58285,KALIMANTAN BARAT,58567,SANGGAU,58568,KAPUAS,20954,27512,48466
58285,KALIMANTAN BARAT,58567,SANGGAU,58648,KEMBAYAN,3977,13693,17670
58285,KALIMANTAN BARAT,58567,SANGGAU,58724,MELIAU,10149,17941,28090
58285,KALIMANTAN BARAT,58567,SANGGAU,58594,MUKOK,4080,6951,11031
58285,KALIMANTAN BARAT,58567,SANGGAU,58603,NOYAN,454,5709,6163
58285,KALIMANTAN BARAT,58567,SANGGAU,58660,PARINDU,2581,18821,21402
58285,KALIMANTAN BARAT,58567,SANGGAU,58637,SEKAYAM,5367,11957,17324
58285,KALIMANTAN BARAT,58567,SANGGAU,58687,TAYAN HILIR,5818,13020,18838
58285,KALIMANTAN BARAT,58567,SANGGAU,58675,TAYAN HULU,3146,17721,20867
58285,KALIMANTAN BARAT,58567,SANGGAU,58716,TOBA,793,7217,8010
58285,KALIMANTAN BARAT,59869,SEKADAU,59947,BELITANG,2481,4461,6942
58285,KALIMANTAN BARAT,59869,SEKADAU,59925,BELITANG HILIR,3630,10303,13933
58285,KALIMANTAN BARAT,59869,SEKADAU,59934,BELITANG HULU,1493,12457,13950
58285,KALIMANTAN BARAT,59869,SEKADAU,59913,NANGA MAHAP,3381,10754,14135
58285,KALIMANTAN BARAT,59869,SEKADAU,59900,NANGA TAMAN,3275,12587,15862
58285,KALIMANTAN BARAT,59869,SEKADAU,59870,SEKADAU HILIR,12641,21454,34095
58285,KALIMANTAN BARAT,59869,SEKADAU,59885,SEKADAU HULU,4095,12297,16392
58285,KALIMANTAN BARAT,59018,SINTANG,59255,AMBALAU,1243,7422,8665
58285,KALIMANTAN BARAT,59018,SINTANG,59308,BINJAI HULU,2607,4081,6688
58285,KALIMANTAN BARAT,59018,SINTANG,59152,DEDAI,7128,11680,18808
58285,KALIMANTAN BARAT,59018,SINTANG,59173,KAYAN HILIR,3406,16144,19550
58285,KALIMANTAN BARAT,59018,SINTANG,59200,KAYAN HULU,5029,12707,17736
58285,KALIMANTAN BARAT,59018,SINTANG,59269,KELAM PERMAI,2017,8265,10282
58285,KALIMANTAN BARAT,59018,SINTANG,59094,KETUNGAU HILIR,1712,11590,13302
58285,KALIMANTAN BARAT,59018,SINTANG,59133,KETUNGAU HULU,1697,10234,11931
58285,KALIMANTAN BARAT,59018,SINTANG,59112,KETUNGAU TENGAH,1787,15700,17487
58285,KALIMANTAN BARAT,59018,SINTANG,59060,SEPAUK,7129,22776,29905
58285,KALIMANTAN BARAT,59018,SINTANG,59230,SERAWAI,3297,9761,13058
58285,KALIMANTAN BARAT,59018,SINTANG,59019,SINTANG,23222,16480,39702
58285,KALIMANTAN BARAT,59018,SINTANG,59286,SUNGAI TEBELIAN,6573,10767,17340
58285,KALIMANTAN BARAT,59018,SINTANG,59035,TEMPUNAK,4008,13032,17040
61965,KALIMANTAN SELATAN,63866,BALANGAN,63911,AWAYAN,3408,3740,7148
61965,KALIMANTAN SELATAN,63866,BALANGAN,63935,BATU MANDI,4709,4684,9393
61965,KALIMANTAN SELATAN,63866,BALANGAN,63889,HALONG,3664,5516,9180
61965,KALIMANTAN SELATAN,63866,BALANGAN,63867,JUAI,4012,4586,8598
61965,KALIMANTAN SELATAN,63866,BALANGAN,63954,LAMPIHONG,4063,4784,8847
61965,KALIMANTAN SELATAN,63866,BALANGAN,63982,PARINGIN,4899,4127,9026
61965,KALIMANTAN SELATAN,63866,BALANGAN,63999,PARINGIN SELATAN,3761,2963,6724
61965,KALIMANTAN SELATAN,63866,BALANGAN,64016,TEBING TINGGI,790,2515,3305
61965,KALIMANTAN SELATAN,62333,BANJAR,62334,ALUH ALUH,0,0,0
61965,KALIMANTAN SELATAN,62333,BANJAR,62534,ARANIO,0,0,0
61965,KALIMANTAN SELATAN,62333,BANJAR,62459,ASTAMBUL,0,0,0
61965,KALIMANTAN SELATAN,62333,BANJAR,62563,BERUNTUNG BARU,0,0,0
61965,KALIMANTAN SELATAN,62333,BANJAR,62368,GAMBUT,0,0,0
61965,KALIMANTAN SELATAN,62333,BANJAR,62432,KARANG INTAN,0,0,0
61965,KALIMANTAN SELATAN,62333,BANJAR,62354,KERTAK HANYAR,0,0,0
61965,KALIMANTAN SELATAN,62333,BANJAR,62405,MARTAPURA,0,0,0
61965,KALIMANTAN SELATAN,62333,BANJAR,62576,MARTAPURA BARAT,0,0,0
61965,KALIMANTAN SELATAN,62333,BANJAR,62590,MARTAPURA TIMUR,0,0,0
61965,KALIMANTAN SELATAN,62333,BANJAR,62547,MATARAMAN,0,0,0
61965,KALIMANTAN SELATAN,62333,BANJAR,62619,PARAMASAN,0,0,0
61965,KALIMANTAN SELATAN,62333,BANJAR,62509,PENGAROM,0,0,0
61965,KALIMANTAN SELATAN,62333,BANJAR,62611,SAMBUNG MAKMUR,0,0,0
61965,KALIMANTAN SELATAN,62333,BANJAR,62482,SIMPANG EMPAT,0,0,0
61965,KALIMANTAN SELATAN,62333,BANJAR,62522,SUNGAI PINANG,0,0,0
61965,KALIMANTAN SELATAN,62333,BANJAR,62383,SUNGAI TABUK,0,0,0
61965,KALIMANTAN SELATAN,62333,BANJAR,62629,TATAH MAKMUR,0,0,0
61965,KALIMANTAN SELATAN,62333,BANJAR,62624,TELAGA BAUNTUNG,0,0,0
61965,KALIMANTAN SELATAN,62643,BARITO KUALA,62708,ALALAK,12862,12154,25016
61965,KALIMANTAN SELATAN,62643,BARITO KUALA,62692,ANJIR MUARA,5356,4948,10304
61965,KALIMANTAN SELATAN,62643,BARITO KUALA,62676,ANJIR PASAR,4752,3874,8626
61965,KALIMANTAN SELATAN,62643,BARITO KUALA,62775,BAKUMPAI,2544,2275,4819
61965,KALIMANTAN SELATAN,62643,BARITO KUALA,62817,BARAMBAI,3780,3324,7104
61965,KALIMANTAN SELATAN,62643,BARITO KUALA,62752,BELAWANG,3197,3518,6715
61965,KALIMANTAN SELATAN,62643,BARITO KUALA,62766,CERBON,1974,2622,4596
61965,KALIMANTAN SELATAN,62643,BARITO KUALA,62853,JEJANGKIT,1443,1577,3020
61965,KALIMANTAN SELATAN,62643,BARITO KUALA,62785,KURIPAN,1529,1504,3033
61965,KALIMANTAN SELATAN,62643,BARITO KUALA,62727,MANDASTANA,3821,4160,7981
61965,KALIMANTAN SELATAN,62643,BARITO KUALA,62829,MARABAHAN,6232,4569,10801
61965,KALIMANTAN SELATAN,62643,BARITO KUALA,62807,MEKARSARI,3346,4559,7905
61965,KALIMANTAN SELATAN,62643,BARITO KUALA,62742,RANTAU BADAUH,3814,3621,7435
61965,KALIMANTAN SELATAN,62643,BARITO KUALA,62795,TABUKAN,1730,2449,4179
61965,KALIMANTAN SELATAN,62643,BARITO KUALA,62644,TABUNGANEN,3875,5014,8889
61965,KALIMANTAN SELATAN,62643,BARITO KUALA,62659,TAMBAN,7260,7606,14866
61965,KALIMANTAN SELATAN,62643,BARITO KUALA,62839,WANARAYA,3375,4194,7569
61965,KALIMANTAN SELATAN,63007,HULU SUNGAI SELATAN,63057,ANGKINANG,5313,4034,9347
61965,KALIMANTAN SELATAN,63007,HULU SUNGAI SELATAN,63159,DAHA BARAT,917,2314,3231
61965,KALIMANTAN SELATAN,63007,HULU SUNGAI SELATAN,63100,DAHA SELATAN,6379,11190,17569
61965,KALIMANTAN SELATAN,63007,HULU SUNGAI SELATAN,63117,DAHA UTARA,7031,6792,13823
61965,KALIMANTAN SELATAN,63007,HULU SUNGAI SELATAN,63137,KALUMPANG,1843,1363,3206
61965,KALIMANTAN SELATAN,63007,HULU SUNGAI SELATAN,63069,KANDANGAN,13147,9689,22836
61965,KALIMANTAN SELATAN,63007,HULU SUNGAI SELATAN,63147,LOKSADO,1037,3080,4117
61965,KALIMANTAN SELATAN,63007,HULU SUNGAI SELATAN,63027,PADANG BATUNG,5604,5159,10763
61965,KALIMANTAN SELATAN,63007,HULU SUNGAI SELATAN,63088,SIMPUR,4801,2714,7515
61965,KALIMANTAN SELATAN,63007,HULU SUNGAI SELATAN,63008,SUNGAI RAYA,4945,3888,8833
61965,KALIMANTAN SELATAN,63007,HULU SUNGAI SELATAN,63045,TELAGA LANGSAT,0,0,0
61965,KALIMANTAN SELATAN,63167,HULU SUNGAI TENGAH,63259,BARABAI,18714,9099,27813
61965,KALIMANTAN SELATAN,63167,HULU SUNGAI TENGAH,63278,BATANG ALAI SELATAN,8100,4989,13089
61965,KALIMANTAN SELATAN,63167,HULU SUNGAI TENGAH,63326,BATANG ALAI TIMUR,1434,1765,3199
61965,KALIMANTAN SELATAN,63167,HULU SUNGAI TENGAH,63298,BATANG ALAI UTARA,5279,4033,9312
61965,KALIMANTAN SELATAN,63167,HULU SUNGAI TENGAH,63186,BATU BENAWA,6293,4516,10809
61965,KALIMANTAN SELATAN,63167,HULU SUNGAI TENGAH,63313,HANTAKAN,2496,3484,5980
61965,KALIMANTAN SELATAN,63167,HULU SUNGAI TENGAH,63168,HARUYAN,6318,4763,11081
61965,KALIMANTAN SELATAN,63167,HULU SUNGAI TENGAH,63201,LABUAN AMAS SELATAN,8580,5780,14360
61965,KALIMANTAN SELATAN,63167,HULU SUNGAI TENGAH,63220,LABUAN AMAS UTARA,7728,5283,13011
61965,KALIMANTAN SELATAN,63167,HULU SUNGAI TENGAH,63338,LIMPASU,3305,2570,5875
61965,KALIMANTAN SELATAN,63167,HULU SUNGAI TENGAH,63237,PANDAWAN,11537,5725,17262
61965,KALIMANTAN SELATAN,63348,HULU SUNGAI UTARA,63424,AMUNTAI SELATAN,7944,5079,13023
61965,KALIMANTAN SELATAN,63348,HULU SUNGAI UTARA,63455,AMUNTAI TENGAH,14729,9945,24674
61965,KALIMANTAN SELATAN,63348,HULU SUNGAI UTARA,63485,AMUNTAI UTARA,6442,3757,10199
61965,KALIMANTAN SELATAN,63348,HULU SUNGAI UTARA,63366,BABIRIK,4556,3736,8292
61965,KALIMANTAN SELATAN,63348,HULU SUNGAI UTARA,63512,BANJANG,4627,3585,8212
61965,KALIMANTAN SELATAN,63348,HULU SUNGAI UTARA,63349,DANAU PANGGANG,4883,3812,8695
61965,KALIMANTAN SELATAN,63348,HULU SUNGAI UTARA,63533,HAUR GADING,4157,3434,7591
61965,KALIMANTAN SELATAN,63348,HULU SUNGAI UTARA,63552,PAMINGGIR,1837,1549,3386
61965,KALIMANTAN SELATAN,63348,HULU SUNGAI UTARA,63390,SUNGAI PANDAN,7707,5087,12794
61965,KALIMANTAN SELATAN,63348,HULU SUNGAI UTARA,63560,SUNGAI TABUKAN,3296,3084,6380
61965,KALIMANTAN SELATAN,64085,KOTA BANJARBARU,64106,BANJARBARU SELATAN,11819,10989,22808
61965,KALIMANTAN SELATAN,64085,KOTA BANJARBARU,64101,BANJARBARU UTARA,13226,10850,24076
61965,KALIMANTAN SELATAN,64085,KOTA BANJARBARU,64091,CEMPAKA,7260,7468,14728
61965,KALIMANTAN SELATAN,64085,KOTA BANJARBARU,64086,LANDASAN ULIN,14219,14957,29176
61965,KALIMANTAN SELATAN,64085,KOTA BANJARBARU,64096,LIANG ANGGANG,7174,8927,16101
61965,KALIMANTAN SELATAN,64027,KOTA BANJARMASIN,64051,BANJARMASIN BARAT,33862,35323,69185
61965,KALIMANTAN SELATAN,64027,KOTA BANJARMASIN,64028,BANJARMASIN SELATAN,33609,38367,71976
61965,KALIMANTAN SELATAN,64027,KOTA BANJARMASIN,64072,BANJARMASIN TENGAH,22261,24492,46753
61965,KALIMANTAN SELATAN,64027,KOTA BANJARMASIN,64041,BANJARMASIN TIMUR,27192,28785,55977
61965,KALIMANTAN SELATAN,64027,KOTA BANJARMASIN,64061,BANJARMASIN UTARA,36898,30095,66993
61965,KALIMANTAN SELATAN,62112,KOTABARU,62275,HAMPANG,0,0,0
61965,KALIMANTAN SELATAN,62112,KOTABARU,62292,KELUMPANG BARAT,0,0,0
61965,KALIMANTAN SELATAN,62112,KOTABARU,62317,KELUMPANG HILIR,0,0,0
61965,KALIMANTAN SELATAN,62112,KOTABARU,62205,KELUMPANG HULU,0,0,0
61965,KALIMANTAN SELATAN,62112,KOTABARU,62195,KELUMPANG SELATAN,0,0,0
61965,KALIMANTAN SELATAN,62112,KOTABARU,62216,KELUMPANG TENGAH,0,0,0
61965,KALIMANTAN SELATAN,62112,KOTABARU,62230,KELUMPANG UTARA,0,0,0
61965,KALIMANTAN SELATAN,62112,KOTABARU,62327,PAMUKAN BARAT,0,0,0
61965,KALIMANTAN SELATAN,62112,KOTABARU,62238,PAMUKAN SELATAN,0,0,0
61965,KALIMANTAN SELATAN,62112,KOTABARU,62261,PAMUKAN UTARA,0,0,0
61965,KALIMANTAN SELATAN,62112,KOTABARU,62119,PULAULAUT BARAT,0,0,0
61965,KALIMANTAN SELATAN,62112,KOTABARU,62307,PULAULAUT KEPULAUAN,0,0,0
61965,KALIMANTAN SELATAN,62112,KOTABARU,62141,PULAULAUT SELATAN,0,0,0
61965,KALIMANTAN SELATAN,62112,KOTABARU,83672,PULAULAUT TANJUNG SELAYAR,0,0,0
61965,KALIMANTAN SELATAN,62112,KOTABARU,62299,PULAULAUT TENGAH,0,0,0
61965,KALIMANTAN SELATAN,62112,KOTABARU,62149,PULAULAUT TIMUR,0,0,0
61965,KALIMANTAN SELATAN,62112,KOTABARU,62173,PULAULAUT UTARA,0,0,0
61965,KALIMANTAN SELATAN,62112,KOTABARU,62164,PULAUSEBUKU,0,0,0
61965,KALIMANTAN SELATAN,62112,KOTABARU,62113,PULAUSEMBILAN,0,0,0
61965,KALIMANTAN SELATAN,62112,KOTABARU,62250,SAMPANAHAN,0,0,0
61965,KALIMANTAN SELATAN,62112,KOTABARU,62284,SUNGAIDURIAN,0,0,0
61965,KALIMANTAN SELATAN,63578,TABALONG,63579,BANUA LAWAS,5834,3174,9008
61965,KALIMANTAN SELATAN,63578,TABALONG,63712,BINTANG ARA,2405,2383,4788
61965,KALIMANTAN SELATAN,63578,TABALONG,63639,HARUAI,7152,4678,11830
61965,KALIMANTAN SELATAN,63578,TABALONG,63702,JARO,3190,3559,6749
61965,KALIMANTAN SELATAN,63578,TABALONG,63595,KELUA,8062,3468,11530
61965,KALIMANTAN SELATAN,63578,TABALONG,63679,MUARA HARUS,1756,1352,3108
61965,KALIMANTAN SELATAN,63578,TABALONG,63664,MUARA UYA,5430,6476,11906
61965,KALIMANTAN SELATAN,63578,TABALONG,63653,MURUNG PUDAK,14184,10608,24792
61965,KALIMANTAN SELATAN,63578,TABALONG,63687,PUGAAN,2637,1011,3648
61965,KALIMANTAN SELATAN,63578,TABALONG,63623,TANJUNG,11263,6945,18208
61965,KALIMANTAN SELATAN,63578,TABALONG,63608,TANTA,5384,4440,9824
61965,KALIMANTAN SELATAN,63578,TABALONG,63695,UPAU,1544,2309,3853
61965,KALIMANTAN SELATAN,63722,TANAH BUMBU,63814,ANGSANA,0,0,0
61965,KALIMANTAN SELATAN,63722,TANAH BUMBU,63723,BATU LICIN,0,0,0
61965,KALIMANTAN SELATAN,63722,TANAH BUMBU,63830,KARANG BINTANG,0,0,0
61965,KALIMANTAN SELATAN,63722,TANAH BUMBU,63823,KURANJI,0,0,0
61965,KALIMANTAN SELATAN,63722,TANAH BUMBU,63729,KUSAN HILIR,0,0,0
61965,KALIMANTAN SELATAN,63722,TANAH BUMBU,63793,KUSAN HULU,0,0,0
61965,KALIMANTAN SELATAN,63722,TANAH BUMBU,63854,MANTEWE,0,0,0
61965,KALIMANTAN SELATAN,63722,TANAH BUMBU,63778,SATUI,0,0,0
61965,KALIMANTAN SELATAN,63722,TANAH BUMBU,63841,SIMPANG EMPAT,0,0,0
61965,KALIMANTAN SELATAN,63722,TANAH BUMBU,63765,SUNGAI LOBAN,0,0,0
61965,KALIMANTAN SELATAN,61966,TANAH LAUT,62090,BAJUIN,4386,4436,8822
61965,KALIMANTAN SELATAN,61966,TANAH LAUT,62024,BATI BATI,9004,10126,19130
61965,KALIMANTAN SELATAN,61966,TANAH LAUT,62075,BATU AMPAR,6238,6690,12928
61965,KALIMANTAN SELATAN,61966,TANAH LAUT,62100,BUMI MAKMUR,2293,3295,5588
61965,KALIMANTAN SELATAN,61966,TANAH LAUT,61980,JORONG,5597,7989,13586
61965,KALIMANTAN SELATAN,61966,TANAH LAUT,62050,KINTAP,6495,12524,19019
61965,KALIMANTAN SELATAN,61966,TANAH LAUT,62012,KURAU,2688,3466,6154
61965,KALIMANTAN SELATAN,61966,TANAH LAUT,62039,PANYIPATAN,4213,6476,10689
61965,KALIMANTAN SELATAN,61966,TANAH LAUT,61991,PELAIHARI,19918,15205,35123
61965,KALIMANTAN SELATAN,61966,TANAH LAUT,61967,TAKISUNG,7242,7522,14764
61965,KALIMANTAN SELATAN,61966,TANAH LAUT,62065,TAMBANG ULANG,4021,4163,8184
61965,KALIMANTAN SELATAN,62861,TAPIN,62946,BAKARANGAN,2476,1982,4458
61965,KALIMANTAN SELATAN,62861,TAPIN,62862,BINUANG,13102,4788,17890
61965,KALIMANTAN SELATAN,62861,TAPIN,62968,BUNGUR,3562,2748,6310
61965,KALIMANTAN SELATAN,62861,TAPIN,62919,CANDI LARAS SELATAN,3196,2799,5995
61965,KALIMANTAN SELATAN,62861,TAPIN,62932,CANDI LARAS UTARA,3611,4377,7988
61965,KALIMANTAN SELATAN,62861,TAPIN,62991,HATUNGUN,3103,2073,5176
61965,KALIMANTAN SELATAN,62861,TAPIN,62981,LOKPAIKAT,2795,2538,5333
61965,KALIMANTAN SELATAN,62861,TAPIN,62959,PIANI,1512,1693,3205
61965,KALIMANTAN SELATAN,62861,TAPIN,63000,SALAM BABARIS,4325,2370,6695
61965,KALIMANTAN SELATAN,62861,TAPIN,62873,TAPIN SELATAN,6637,3289,9926
61965,KALIMANTAN SELATAN,62861,TAPIN,62884,TAPIN TENGAH,5711,4398,10109
61965,KALIMANTAN SELATAN,62861,TAPIN,62902,TAPIN UTARA,8151,4685,12836
60371,KALIMANTAN TENGAH,60867,BARITO SELATAN,60874,DUSUN HILIR,3948,3551,7499
60371,KALIMANTAN TENGAH,60867,BARITO SELATAN,60939,DUSUN SELATAN,12490,14068,26558
60371,KALIMANTAN TENGAH,60867,BARITO SELATAN,60897,DUSUN UTARA,2150,5801,7951
60371,KALIMANTAN TENGAH,60867,BARITO SELATAN,60868,JENAMAS,1969,2254,4223
60371,KALIMANTAN TENGAH,60867,BARITO SELATAN,60885,KARAU KUALA,2584,4846,7430
60371,KALIMANTAN TENGAH,61846,BARITO TIMUR,61874,AWANG,710,2866,3576
60371,KALIMANTAN TENGAH,61846,BARITO TIMUR,61859,BANUA LIMA,1144,2278,3422
60371,KALIMANTAN TENGAH,61846,BARITO TIMUR,61883,DUSUN TENGAH,5297,6576,11873
60371,KALIMANTAN TENGAH,61846,BARITO TIMUR,61847,DUSUN TIMUR,4528,8618,13146
60371,KALIMANTAN TENGAH,61846,BARITO TIMUR,61921,KARUSEN JANANG,703,1750,2453
60371,KALIMANTAN TENGAH,61846,BARITO TIMUR,61901,PAJU EPAT,996,1798,2794
60371,KALIMANTAN TENGAH,61846,BARITO TIMUR,61915,PAKU,910,3416,4326
60371,KALIMANTAN TENGAH,61846,BARITO TIMUR,61866,PATANGKEP TUTUI,880,2839,3719
60371,KALIMANTAN TENGAH,61846,BARITO TIMUR,61890,PEMATANG KARAU,3344,2984,6328
60371,KALIMANTAN TENGAH,61846,BARITO TIMUR,61909,RAREN BATUAH,1395,2927,4322
60371,KALIMANTAN TENGAH,60967,BARITO UTARA,60996,GUNUNG PUREI,0,0,0
60371,KALIMANTAN TENGAH,60967,BARITO UTARA,60979,GUNUNG TIMANG,0,0,0
60371,KALIMANTAN TENGAH,60967,BARITO UTARA,61052,LAHEI,0,0,0
60371,KALIMANTAN TENGAH,60967,BARITO UTARA,83705,LAHEI BARAT,0,0,0
60371,KALIMANTAN TENGAH,60967,BARITO UTARA,60968,MONTALLAT,0,0,0
60371,KALIMANTAN TENGAH,60967,BARITO UTARA,83701,TEWEH BARU,0,0,0
60371,KALIMANTAN TENGAH,60967,BARITO UTARA,83703,TEWEH SELATAN,0,0,0
60371,KALIMANTAN TENGAH,60967,BARITO UTARA,61024,TEWEH TENGAH,0,0,0
60371,KALIMANTAN TENGAH,60967,BARITO UTARA,61008,TEWEH TIMUR,0,0,0
60371,KALIMANTAN TENGAH,61492,GUNUNG MAS,61574,DAMANG BATU,0,0,0
60371,KALIMANTAN TENGAH,61492,GUNUNG MAS,61526,KAHAYAN HULU UTARA,0,0,0
60371,KALIMANTAN TENGAH,61492,GUNUNG MAS,61493,KURUN,0,0,0
60371,KALIMANTAN TENGAH,61492,GUNUNG MAS,61607,MAHUNING RAYA,0,0,0
60371,KALIMANTAN TENGAH,61492,GUNUNG MAS,61561,MANUHING,0,0,0
60371,KALIMANTAN TENGAH,61492,GUNUNG MAS,83811,MIHING RAYA,0,0,0
60371,KALIMANTAN TENGAH,61492,GUNUNG MAS,61583,MIRI MANASA,0,0,0
60371,KALIMANTAN TENGAH,61492,GUNUNG MAS,61539,RUNGAN,0,0,0
60371,KALIMANTAN TENGAH,61492,GUNUNG MAS,83718,RUNGAN BARAT,0,0,0
60371,KALIMANTAN TENGAH,61492,GUNUNG MAS,61595,RUNGAN HULU,0,0,0
60371,KALIMANTAN TENGAH,61492,GUNUNG MAS,83716,SEPANG SIMIN,0,0,0
60371,KALIMANTAN TENGAH,61492,GUNUNG MAS,61509,TEWAH,0,0,0
60371,KALIMANTAN TENGAH,60653,KAPUAS,60768,BASARANG,4827,3812,8639
60371,KALIMANTAN TENGAH,60653,KAPUAS,83697,BATAGUH,7811,7929,15740
60371,KALIMANTAN TENGAH,60653,KAPUAS,83696,DADAHUP,2394,3114,5508
60371,KALIMANTAN TENGAH,60653,KAPUAS,60710,KAPUAS BARAT,4029,4389,8418
60371,KALIMANTAN TENGAH,60653,KAPUAS,60674,KAPUAS HILIR,3084,3600,6684
60371,KALIMANTAN TENGAH,60653,KAPUAS,60846,KAPUAS HULU,535,4208,4743
60371,KALIMANTAN TENGAH,60653,KAPUAS,60691,KAPUAS KUALA,4770,4539,9309
60371,KALIMANTAN TENGAH,60653,KAPUAS,60731,KAPUAS MURUNG,6091,5793,11884
60371,KALIMANTAN TENGAH,60653,KAPUAS,60825,KAPUAS TENGAH,1039,5480,6519
60371,KALIMANTAN TENGAH,60653,KAPUAS,60683,KAPUAS TIMUR,7219,4399,11618
60371,KALIMANTAN TENGAH,60653,KAPUAS,83695,MANDAU TALAWANG,271,2139,2410
60371,KALIMANTAN TENGAH,60653,KAPUAS,60783,MANTANGAI,6179,9578,15757
60371,KALIMANTAN TENGAH,60653,KAPUAS,83693,PASAK TALAWANG,604,2399,3003
60371,KALIMANTAN TENGAH,60653,KAPUAS,60722,PULAU PETAK,5036,3795,8831
60371,KALIMANTAN TENGAH,60653,KAPUAS,60654,SELAT,20087,11276,31363
60371,KALIMANTAN TENGAH,60653,KAPUAS,83689,TAMBAN CATUR,3191,3654,6845
60371,KALIMANTAN TENGAH,60653,KAPUAS,60815,TIMPAH,988,3298,4286
60371,KALIMANTAN TENGAH,61077,KATINGAN,61239,BUKIT RAYA,448,1984,2432
60371,KALIMANTAN TENGAH,61077,KATINGAN,61078,KAMIPANG,1133,1669,2802
60371,KALIMANTAN TENGAH,61077,KATINGAN,61088,KATINGAN HILIR,4907,8912,13819
60371,KALIMANTAN TENGAH,61077,KATINGAN,61174,KATINGAN HULU,1026,2974,4000
60371,KALIMANTAN TENGAH,61077,KATINGAN,61205,KATINGAN KUALA,4553,4998,9551
60371,KALIMANTAN TENGAH,61077,KATINGAN,61123,KATINGAN TENGAH,3673,8836,12509
60371,KALIMANTAN TENGAH,61077,KATINGAN,61155,MARIKIT,571,2748,3319
60371,KALIMANTAN TENGAH,61077,KATINGAN,61197,MENDAWAI,1027,819,1846
60371,KALIMANTAN TENGAH,61077,KATINGAN,61231,PETAK MALAI,269,1284,1553
60371,KALIMANTAN TENGAH,61077,KATINGAN,61108,PULAU MALAN,1150,3049,4199
60371,KALIMANTAN TENGAH,61077,KATINGAN,61140,SANAMAN MANTIKEI,1167,4357,5524
60371,KALIMANTAN TENGAH,61077,KATINGAN,61222,TASIK PAYAWAN,1403,2008,3411
60371,KALIMANTAN TENGAH,61077,KATINGAN,61097,TEWANG SANGALANG GARING,1268,4607,5875
60371,KALIMANTAN TENGAH,61929,KOTA PALANGKARAYA,61937,BUKIT BATU,2195,4143,6338
60371,KALIMANTAN TENGAH,61929,KOTA PALANGKARAYA,61945,JEKAN RAYA,26344,35339,61683
60371,KALIMANTAN TENGAH,61929,KOTA PALANGKARAYA,61930,PAHANDUT,21676,19147,40823
60371,KALIMANTAN TENGAH,61929,KOTA PALANGKARAYA,61957,RAKUMPIT,464,1168,1632
60371,KALIMANTAN TENGAH,61929,KOTA PALANGKARAYA,61950,SABANGAU,4008,4054,8062
60371,KALIMANTAN TENGAH,60372,KOTAWARINGIN BARAT,60391,ARUT SELATAN,27766,25190,52956
60371,KALIMANTAN TENGAH,60372,KOTAWARINGIN BARAT,60430,ARUT UTARA,1589,3886,5475
60371,KALIMANTAN TENGAH,60372,KOTAWARINGIN BARAT,60412,KOTAWARINGIN LAMA,4206,5724,9930
60371,KALIMANTAN TENGAH,60372,KOTAWARINGIN BARAT,60373,KUMAI,14631,10152,24783
60371,KALIMANTAN TENGAH,60372,KOTAWARINGIN BARAT,60454,PANGKALAN BANTENG,6264,9349,15613
60371,KALIMANTAN TENGAH,60372,KOTAWARINGIN BARAT,60442,PANGKALAN LADA,6837,10940,17777
60371,KALIMANTAN TENGAH,60468,KOTAWARINGIN TIMUR,60578,ANTANG KALANG,1483,7385,8868
60371,KALIMANTAN TENGAH,60468,KOTAWARINGIN TIMUR,60532,BAAMANG,14164,12625,26789
60371,KALIMANTAN TENGAH,60468,KOTAWARINGIN TIMUR,60638,BUKIT SANTUAI,1406,5022,6428
60371,KALIMANTAN TENGAH,60468,KOTAWARINGIN TIMUR,60481,CEMPAGA,3353,5966,9319
60371,KALIMANTAN TENGAH,60468,KOTAWARINGIN TIMUR,60620,CEMPAGA HULU,2817,9799,12616
60371,KALIMANTAN TENGAH,60468,KOTAWARINGIN TIMUR,60469,KOTA BESI,2640,5479,8119
60371,KALIMANTAN TENGAH,60468,KOTAWARINGIN TIMUR,60539,MENTAWA BARU KETAPANG,23328,20087,43415
60371,KALIMANTAN TENGAH,60468,KOTAWARINGIN TIMUR,60556,MENTAYA HILIR SELATAN,5386,4543,9929
60371,KALIMANTAN TENGAH,60468,KOTAWARINGIN TIMUR,60548,MENTAYA HILIR UTARA,3057,4975,8032
60371,KALIMANTAN TENGAH,60468,KOTAWARINGIN TIMUR,60490,MENTAYA HULU,4118,10643,14761
60371,KALIMANTAN TENGAH,60468,KOTAWARINGIN TIMUR,60507,PARENGGEAN,3899,10398,14297
60371,KALIMANTAN TENGAH,60468,KOTAWARINGIN TIMUR,60567,PULAU HANAUT,3120,3880,7000
60371,KALIMANTAN TENGAH,60468,KOTAWARINGIN TIMUR,60614,SERANAU,2468,2855,5323
60371,KALIMANTAN TENGAH,60468,KOTAWARINGIN TIMUR,83683,TELAGA ANTANG,2269,7681,9950
60371,KALIMANTAN TENGAH,60468,KOTAWARINGIN TIMUR,60631,TELAWANG,2278,9310,11588
60371,KALIMANTAN TENGAH,60468,KOTAWARINGIN TIMUR,60609,TELUK SAMPIT,2067,2080,4147
60371,KALIMANTAN TENGAH,60468,KOTAWARINGIN TIMUR,83681,TUALAN HULU,1353,4950,6303
60371,KALIMANTAN TENGAH,61400,LAMANDAU,61482,BATANG KAWA,349,1060,1409
60371,KALIMANTAN TENGAH,61400,LAMANDAU,61469,BELANTIKAN RAYA,979,1979,2958
60371,KALIMANTAN TENGAH,61400,LAMANDAU,61423,BULIK,4014,6705,10719
60371,KALIMANTAN TENGAH,61400,LAMANDAU,61436,BULIK TIMUR,1279,2250,3529
60371,KALIMANTAN TENGAH,61400,LAMANDAU,61412,DELANG,792,1965,2757
60371,KALIMANTAN TENGAH,61400,LAMANDAU,61401,LAMANDAU,950,2110,3060
60371,KALIMANTAN TENGAH,61400,LAMANDAU,61449,MENTHOBI RAYA,1565,3671,5236
60371,KALIMANTAN TENGAH,61400,LAMANDAU,61461,SEMATU JAYA,1811,4149,5960
60371,KALIMANTAN TENGAH,61711,MURUNG RAYA,61806,BARITO TUHUP RAYA,759,1580,2339
60371,KALIMANTAN TENGAH,61711,MURUNG RAYA,61756,LAUNG TUHUP,4228,3999,8227
60371,KALIMANTAN TENGAH,61711,MURUNG RAYA,61712,MURUNG,10398,5786,16184
60371,KALIMANTAN TENGAH,61711,MURUNG RAYA,61783,PERMATA INTAN,2203,2582,4785
60371,KALIMANTAN TENGAH,61711,MURUNG RAYA,61832,SERIBU RIAM,304,1233,1537
60371,KALIMANTAN TENGAH,61711,MURUNG RAYA,61796,SUMBER BARITO,773,2111,2884
60371,KALIMANTAN TENGAH,61711,MURUNG RAYA,61825,SUNGAI BABUAT,218,1051,1269
60371,KALIMANTAN TENGAH,61711,MURUNG RAYA,61728,TANAH SIANG,1011,4467,5478
60371,KALIMANTAN TENGAH,61711,MURUNG RAYA,61818,TANAH SIANG SELATAN,457,1732,2189
60371,KALIMANTAN TENGAH,61711,MURUNG RAYA,61840,UUT MURUNG,381,927,1308
60371,KALIMANTAN TENGAH,61614,PULANG PISAU,61657,BANAMA TINGANG,626,4299,4925
60371,KALIMANTAN TENGAH,61614,PULANG PISAU,61696,JABIREN,1401,2850,4251
60371,KALIMANTAN TENGAH,61614,PULANG PISAU,61673,KAHAYAN HILIR,5700,7699,13399
60371,KALIMANTAN TENGAH,61614,PULANG PISAU,61631,KAHAYAN KUALA,4174,3666,7840
60371,KALIMANTAN TENGAH,61614,PULANG PISAU,61642,KAHAYAN TENGAH,685,3638,4323
60371,KALIMANTAN TENGAH,61614,PULANG PISAU,61682,MALIKU,5122,6908,12030
60371,KALIMANTAN TENGAH,61614,PULANG PISAU,61615,PANDIH BATU,4552,6173,10725
60371,KALIMANTAN TENGAH,61614,PULANG PISAU,61704,SEBANGAU KUALA,935,1758,2693
60371,KALIMANTAN TENGAH,61251,SERUYAN,61342,BATU AMPAR,1546,3407,4953
60371,KALIMANTAN TENGAH,61251,SERUYAN,61335,DANAU SELULUK,3470,7490,10960
60371,KALIMANTAN TENGAH,61251,SERUYAN,61284,DANAU SEMBULUH,1999,3765,5764
60371,KALIMANTAN TENGAH,61251,SERUYAN,61293,HANAU,4827,5678,10505
60371,KALIMANTAN TENGAH,61251,SERUYAN,61252,SERUYAN HILIR,6712,8441,15153
60371,KALIMANTAN TENGAH,61251,SERUYAN,61322,SERUYAN HILIR TIMUR,1874,1703,3577
60371,KALIMANTAN TENGAH,61251,SERUYAN,61301,SERUYAN HULU,1837,3671,5508
60371,KALIMANTAN TENGAH,61251,SERUYAN,61329,SERUYAN RAYA,2125,7681,9806
60371,KALIMANTAN TENGAH,61251,SERUYAN,61263,SERUYAN TENGAH,3573,9003,12576
60371,KALIMANTAN TENGAH,61251,SERUYAN,61352,SULING TAMBUN,626,821,1447
60371,KALIMANTAN TENGAH,61362,SUKAMARA,61378,BALAI RIAM,1218,2692,3910
60371,KALIMANTAN TENGAH,61362,SUKAMARA,61372,JELAI,932,1224,2156
60371,KALIMANTAN TENGAH,61362,SUKAMARA,61387,PANTAI LUNCI,1103,1295,2398
60371,KALIMANTAN TENGAH,61362,SUKAMARA,61392,PERMATA KECUBUNG,928,2340,3268
60371,KALIMANTAN TENGAH,61362,SUKAMARA,61363,SUKAMARA,4254,6648,10902
64111,KALIMANTAN TIMUR,64496,BERAU,64600,BATU PUTIH,0,0,0
64111,KALIMANTAN TIMUR,64496,BERAU,64608,BIATAN,0,0,0
64111,KALIMANTAN TIMUR,64496,BERAU,64556,GUNUNG TABUR,0,0,0
64111,KALIMANTAN TIMUR,64496,BERAU,64497,KELAY,0,0,0
64111,KALIMANTAN TIMUR,64496,BERAU,64595,MARATUA,0,0,0
64111,KALIMANTAN TIMUR,64496,BERAU,64568,PULAU DERAWAN,0,0,0
64111,KALIMANTAN TIMUR,64496,BERAU,64522,SAMBALIUNG,0,0,0
64111,KALIMANTAN TIMUR,64496,BERAU,64537,SEGAH,0,0,0
64111,KALIMANTAN TIMUR,64496,BERAU,64588,TABALAR,0,0,0
64111,KALIMANTAN TIMUR,64496,BERAU,64512,TALISAYAN,0,0,0
64111,KALIMANTAN TIMUR,64496,BERAU,64549,TANJUNG REDEB,0,0,0
64111,KALIMANTAN TIMUR,64496,BERAU,64581,TELUK BAYUR,0,0,0
64111,KALIMANTAN TIMUR,64617,BULUNGAN,64705,BUNYU,1840,3878,5718
64111,KALIMANTAN TIMUR,64617,BULUNGAN,64664,PESO,557,1486,2043
64111,KALIMANTAN TIMUR,64617,BULUNGAN,64675,PESO ILIR,399,1219,1618
64111,KALIMANTAN TIMUR,64617,BULUNGAN,64682,SEKATAK,549,3510,4059
64111,KALIMANTAN TIMUR,64617,BULUNGAN,64618,TANJUNG PALAS,2952,3393,6345
64111,KALIMANTAN TIMUR,64617,BULUNGAN,64628,TANJUNG PALAS BARAT,658,1963,2621
64111,KALIMANTAN TIMUR,64617,BULUNGAN,64660,TANJUNG PALAS TENGAH,1199,2318,3517
64111,KALIMANTAN TIMUR,64617,BULUNGAN,64641,TANJUNG PALAS TIMUR,956,3996,4952
64111,KALIMANTAN TIMUR,64617,BULUNGAN,64634,TANJUNG PALAS UTARA,1943,3129,5072
64111,KALIMANTAN TIMUR,64617,BULUNGAN,64650,TANJUNG SELOR,6831,11518,18349
64111,KALIMANTAN TIMUR,65528,KOTA BALIKPAPAN,65534,BALIKPAPAN BARAT,19297,25656,44953
64111,KALIMANTAN TIMUR,65528,KOTA BALIKPAPAN,83647,BALIKPAPAN KOTA,18121,25741,43862
64111,KALIMANTAN TIMUR,65528,KOTA BALIKPAPAN,65554,BALIKPAPAN SELATAN,24352,34000,58352
64111,KALIMANTAN TIMUR,65528,KOTA BALIKPAPAN,65546,BALIKPAPAN TENGAH,20727,33164,53891
64111,KALIMANTAN TIMUR,65528,KOTA BALIKPAPAN,65529,BALIKPAPAN TIMUR,13322,19054,32376
64111,KALIMANTAN TIMUR,65528,KOTA BALIKPAPAN,65541,BALIKPAPAN UTARA,27254,39487,66741
64111,KALIMANTAN TIMUR,65656,KOTA BONTANG,65671,BONTANG BARAT,5605,8615,14220
64111,KALIMANTAN TIMUR,65656,KOTA BONTANG,65664,BONTANG SELATAN,10537,21736,32273
64111,KALIMANTAN TIMUR,65656,KOTA BONTANG,65657,BONTANG UTARA,14615,21761,36376
64111,KALIMANTAN TIMUR,65567,KOTA SAMARINDA,65625,LOA JANAN ILIR,10831,15602,26433
64111,KALIMANTAN TIMUR,65567,KOTA SAMARINDA,65568,PALARAN,10153,16772,26925
64111,KALIMANTAN TIMUR,65567,KOTA SAMARINDA,65587,SAMARINDA ILIR,14711,20159,34870
64111,KALIMANTAN TIMUR,65567,KOTA SAMARINDA,65619,SAMARINDA KOTA,6906,11141,18047
64111,KALIMANTAN TIMUR,65567,KOTA SAMARINDA,65574,SAMARINDA SEBERANG,11054,15859,26913
64111,KALIMANTAN TIMUR,65567,KOTA SAMARINDA,65578,SAMARINDA ULU,29889,35084,64973
64111,KALIMANTAN TIMUR,65567,KOTA SAMARINDA,65593,SAMARINDA UTARA,18311,27368,45679
64111,KALIMANTAN TIMUR,65567,KOTA SAMARINDA,65607,SAMBUTAN,10158,12544,22702
64111,KALIMANTAN TIMUR,65567,KOTA SAMARINDA,65599,SUNGAI KUNJANG,25022,31464,56486
64111,KALIMANTAN TIMUR,65567,KOTA SAMARINDA,65613,SUNGAI PINANG,18281,30327,48608
64111,KALIMANTAN TIMUR,65631,KOTA TARAKAN,65632,TARAKAN BARAT,0,0,0
64111,KALIMANTAN TIMUR,65631,KOTA TARAKAN,65638,TARAKAN TENGAH,0,0,0
64111,KALIMANTAN TIMUR,65631,KOTA TARAKAN,65644,TARAKAN TIMUR,0,0,0
64111,KALIMANTAN TIMUR,65631,KOTA TARAKAN,65652,TARAKAN UTARA,0,0,0
64111,KALIMANTAN TIMUR,65069,KUTAI BARAT,65134,BARONG TONGKOK,2441,11156,13597
64111,KALIMANTAN TIMUR,65069,KUTAI BARAT,65229,BENTIAN BESAR,175,1640,1815
64111,KALIMANTAN TIMUR,65069,KUTAI BARAT,65206,BONGAN,1004,4141,5145
64111,KALIMANTAN TIMUR,65069,KUTAI BARAT,65156,DAMAI,923,4652,5575
64111,KALIMANTAN TIMUR,65069,KUTAI BARAT,65193,JEMPANG,1146,4916,6062
64111,KALIMANTAN TIMUR,65069,KUTAI BARAT,65310,LAHAM,185,1021,1206
64111,KALIMANTAN TIMUR,65069,KUTAI BARAT,65239,LINGGANG BIGUNG,924,7210,8134
64111,KALIMANTAN TIMUR,65069,KUTAI BARAT,65070,LONG APARI,1436,867,2303
64111,KALIMANTAN TIMUR,65069,KUTAI BARAT,65093,LONG BAGUN,1507,2183,3690
64111,KALIMANTAN TIMUR,65069,KUTAI BARAT,65105,LONG HUBUNG,1346,2712,4058
64111,KALIMANTAN TIMUR,65069,KUTAI BARAT,65114,LONG IRAM,947,2687,3634
64111,KALIMANTAN TIMUR,65069,KUTAI BARAT,65081,LONG PAHANGAI,1047,1438,2485
64111,KALIMANTAN TIMUR,65069,KUTAI BARAT,65126,MELAK,2271,4324,6595
64111,KALIMANTAN TIMUR,65069,KUTAI BARAT,65275,MOOK MANAAR BULATN,741,3798,4539
64111,KALIMANTAN TIMUR,65069,KUTAI BARAT,65171,MUARA LAWA,714,3098,3812
64111,KALIMANTAN TIMUR,65069,KUTAI BARAT,65180,MUARA PAHU,1084,3020,4104
64111,KALIMANTAN TIMUR,65069,KUTAI BARAT,65249,NYUATAN,417,3303,3720
64111,KALIMANTAN TIMUR,65069,KUTAI BARAT,65223,PENYINGGAHAN,497,1147,1644
64111,KALIMANTAN TIMUR,65069,KUTAI BARAT,65302,SEKOLAQ DARAT,658,5253,5911
64111,KALIMANTAN TIMUR,65069,KUTAI BARAT,65259,SILUQ NGURAI,515,3043,3558
64111,KALIMANTAN TIMUR,65069,KUTAI BARAT,65289,TERING,1183,4016,5199
64111,KALIMANTAN TIMUR,64248,KUTAI KARTANEGARA,64285,ANGGANA,6453,9885,16338
64111,KALIMANTAN TIMUR,64248,KUTAI KARTANEGARA,64366,KEMBANG JANGGUT,2608,7074,9682
64111,KALIMANTAN TIMUR,64248,KUTAI KARTANEGARA,64357,KENOHAN,1359,3717,5076
64111,KALIMANTAN TIMUR,64248,KUTAI KARTANEGARA,64336,KOTA BANGUN,5243,11149,16392
64111,KALIMANTAN TIMUR,64248,KUTAI KARTANEGARA,64276,LOA JANAN,10127,20410,30537
64111,KALIMANTAN TIMUR,64248,KUTAI KARTANEGARA,64263,LOA KULU,8361,13980,22341
64111,KALIMANTAN TIMUR,64248,KUTAI KARTANEGARA,64476,MARANG KAYU,4917,8010,12927
64111,KALIMANTAN TIMUR,64248,KUTAI KARTANEGARA,64294,MUARA BADAK,6634,14631,21265
64111,KALIMANTAN TIMUR,64248,KUTAI KARTANEGARA,64442,MUARA JAWA,8006,9043,17049
64111,KALIMANTAN TIMUR,64248,KUTAI KARTANEGARA,64378,MUARA KAMAN,3958,13989,17947
64111,KALIMANTAN TIMUR,64248,KUTAI KARTANEGARA,64249,MUARA MUNTAI,2260,5523,7783
64111,KALIMANTAN TIMUR,64248,KUTAI KARTANEGARA,64488,MUARA WIS,1399,2930,4329
64111,KALIMANTAN TIMUR,64248,KUTAI KARTANEGARA,64418,SAMBOJA,10818,18001,28819
64111,KALIMANTAN TIMUR,64248,KUTAI KARTANEGARA,64451,SANGA SANGA,3581,5117,8698
64111,KALIMANTAN TIMUR,64248,KUTAI KARTANEGARA,64322,SEBULU,4766,13279,18045
64111,KALIMANTAN TIMUR,64248,KUTAI KARTANEGARA,64398,TABANG,1037,3669,4706
64111,KALIMANTAN TIMUR,64248,KUTAI KARTANEGARA,64308,TENGGARONG,23894,26298,50192
64111,KALIMANTAN TIMUR,64248,KUTAI KARTANEGARA,64457,TENGGARONG SEBERANG,12390,20798,33188
64111,KALIMANTAN TIMUR,65315,KUTAI TIMUR,65454,BATU AMPAR,590,2059,2649
64111,KALIMANTAN TIMUR,65315,KUTAI TIMUR,65388,BENGALON,4468,10412,14880
64111,KALIMANTAN TIMUR,65315,KUTAI TIMUR,65365,BUSANG,0,0,0
64111,KALIMANTAN TIMUR,65315,KUTAI TIMUR,65400,KALIORANG,0,0,0
64111,KALIMANTAN TIMUR,65315,KUTAI TIMUR,65446,KARANGAN,1048,3023,4071
64111,KALIMANTAN TIMUR,65315,KUTAI TIMUR,65437,KAUBUN,0,0,0
64111,KALIMANTAN TIMUR,65315,KUTAI TIMUR,65380,KOMBENG,1868,6182,8050
64111,KALIMANTAN TIMUR,65315,KUTAI TIMUR,65461,LONG MESANGAT,0,0,0
64111,KALIMANTAN TIMUR,65315,KUTAI TIMUR,65316,MUARA ANCALONG,0,0,0
64111,KALIMANTAN TIMUR,65315,KUTAI TIMUR,65336,MUARA BENGKAL,0,0,0
64111,KALIMANTAN TIMUR,65315,KUTAI TIMUR,65325,MUARA WAHAU,0,0,0
64111,KALIMANTAN TIMUR,65315,KUTAI TIMUR,65428,RANTAU PULUNG,1156,2853,4009
64111,KALIMANTAN TIMUR,65315,KUTAI TIMUR,65408,SANDARAN,0,0,0
64111,KALIMANTAN TIMUR,65315,KUTAI TIMUR,65416,SANGATTA SELATAN,0,0,0
64111,KALIMANTAN TIMUR,65315,KUTAI TIMUR,65344,SANGATTA UTARA,18238,25507,43745
64111,KALIMANTAN TIMUR,65315,KUTAI TIMUR,65349,SANGKULIRANG,0,0,0
64111,KALIMANTAN TIMUR,65315,KUTAI TIMUR,65372,TELEN,1259,3747,5006
64111,KALIMANTAN TIMUR,65315,KUTAI TIMUR,65421,TELUK PANDAN,1256,4318,5574
64111,KALIMANTAN TIMUR,64949,MALINAU,65054,BAHAU HULU,74,743,817
64111,KALIMANTAN TIMUR,64949,MALINAU,64982,KAYAN HILIR,291,651,942
64111,KALIMANTAN TIMUR,64949,MALINAU,64988,KAYAN HULU,537,1635,2172
64111,KALIMANTAN TIMUR,64949,MALINAU,65048,KAYAN SELATAN,196,1044,1240
64111,KALIMANTAN TIMUR,64949,MALINAU,65032,MALINAU BARAT,982,3293,4275
64111,KALIMANTAN TIMUR,64949,MALINAU,64965,MALINAU KOTA,2510,6540,9050
64111,KALIMANTAN TIMUR,64949,MALINAU,64994,MALINAU SELATAN,513,2710,3223
64111,KALIMANTAN TIMUR,64949,MALINAU,83638,MALINAU SELATAN HILIR,224,1093,1317
64111,KALIMANTAN TIMUR,64949,MALINAU,83639,MALINAU SELATAN HULU,197,883,1080
64111,KALIMANTAN TIMUR,64949,MALINAU,65019,MALINAU UTARA,1233,3676,4909
64111,KALIMANTAN TIMUR,64949,MALINAU,64950,MENTARANG,594,2021,2615
64111,KALIMANTAN TIMUR,64949,MALINAU,65061,MENTARANG HULU,137,322,459
64111,KALIMANTAN TIMUR,64949,MALINAU,64972,PUJUNGAN,242,624,866
64111,KALIMANTAN TIMUR,64949,MALINAU,65042,SUNGAI BOH,183,1140,1323
64111,KALIMANTAN TIMUR,64949,MALINAU,83640,SUNGAI TUBU,53,378,431
64111,KALIMANTAN TIMUR,64709,NUNUKAN,64829,KRAYAN,0,0,0
64111,KALIMANTAN TIMUR,64709,NUNUKAN,64912,KRAYAN SELATAN,0,0,0
64111,KALIMANTAN TIMUR,64709,NUNUKAN,64754,LUMBIS,0,0,0
64111,KALIMANTAN TIMUR,64709,NUNUKAN,83631,LUMBIS OGONG,0,0,0
64111,KALIMANTAN TIMUR,64709,NUNUKAN,64723,NUNUKAN,0,0,0
64111,KALIMANTAN TIMUR,64709,NUNUKAN,64944,NUNUKAN SELATAN,0,0,0
64111,KALIMANTAN TIMUR,64709,NUNUKAN,64710,SEBATIK,0,0,0
64111,KALIMANTAN TIMUR,64709,NUNUKAN,64936,SEBATIK BARAT,0,0,0
64111,KALIMANTAN TIMUR,64709,NUNUKAN,83628,SEBATIK TENGAH,0,0,0
64111,KALIMANTAN TIMUR,64709,NUNUKAN,83626,SEBATIK TIMUR,0,0,0
64111,KALIMANTAN TIMUR,64709,NUNUKAN,83627,SEBATIK UTARA,0,0,0
64111,KALIMANTAN TIMUR,64709,NUNUKAN,64890,SEBUKU,0,0,0
64111,KALIMANTAN TIMUR,64709,NUNUKAN,83629,SEI MENGGARIS,0,0,0
64111,KALIMANTAN TIMUR,64709,NUNUKAN,64733,SEMBAKUNG,0,0,0
64111,KALIMANTAN TIMUR,64709,NUNUKAN,83630,TULIN ONSOI,0,0,0
64111,KALIMANTAN TIMUR,64112,PASER,64228,BATU ENGAU,2344,4277,6621
64111,KALIMANTAN TIMUR,64112,PASER,64113,BATU SOPANG,3634,5421,9055
64111,KALIMANTAN TIMUR,64112,PASER,64158,KUARO,6188,7001,13189
64111,KALIMANTAN TIMUR,64112,PASER,64170,LONG IKIS,8516,11540,20056
64111,KALIMANTAN TIMUR,64112,PASER,64207,LONG KALI,4104,8227,12331
64111,KALIMANTAN TIMUR,64112,PASER,64194,MUARA KOMAM,2245,3534,5779
64111,KALIMANTAN TIMUR,64112,PASER,64238,MUARA SAMU,1072,1764,2836
64111,KALIMANTAN TIMUR,64112,PASER,64130,PASIR BALENGKONG,5944,6821,12765
64111,KALIMANTAN TIMUR,64112,PASER,64143,TANAH GROGOT,15253,14730,29983
64111,KALIMANTAN TIMUR,64112,PASER,64122,TANJUNG HARAPAN,1082,2123,3205
64111,KALIMANTAN TIMUR,65469,PENAJAM PASER UTARA,65499,BABULU,6886,8711,15597
64111,KALIMANTAN TIMUR,65469,PENAJAM PASER UTARA,65470,PENAJAM,14285,18947,33232
64111,KALIMANTAN TIMUR,65469,PENAJAM PASER UTARA,65512,SEPAKU,0,0,0
64111,KALIMANTAN TIMUR,65469,PENAJAM PASER UTARA,65494,WARU,3107,5074,8181
64111,KALIMANTAN TIMUR,65675,TANA TIDUNG,83646,BETAYAU,0,0,0
64111,KALIMANTAN TIMUR,65675,TANA TIDUNG,65676,SESAYAP,0,0,0
64111,KALIMANTAN TIMUR,65675,TANA TIDUNG,65689,SESAYAP HILIR,0,0,0
64111,KALIMANTAN TIMUR,65675,TANA TIDUNG,65698,TANA LIA,0,0,0
24993,KEPULAUAN BANGKA BELITUNG,24994,BANGKA,25044,BAKAM,0,0,0
24993,KEPULAUAN BANGKA BELITUNG,24994,BANGKA,25003,BELINYU,0,0,0
24993,KEPULAUAN BANGKA BELITUNG,24994,BANGKA,25023,MENDO BARAT,0,0,0
24993,KEPULAUAN BANGKA BELITUNG,24994,BANGKA,25012,MERAWANG,0,0,0
24993,KEPULAUAN BANGKA BELITUNG,24994,BANGKA,25037,PEMALI,0,0,0
24993,KEPULAUAN BANGKA BELITUNG,24994,BANGKA,25064,PUDING BESAR,0,0,0
24993,KEPULAUAN BANGKA BELITUNG,24994,BANGKA,25054,RIAU SILIP,0,0,0
24993,KEPULAUAN BANGKA BELITUNG,24994,BANGKA,24995,SUNGAILIAT,0,0,0
24993,KEPULAUAN BANGKA BELITUNG,25245,BANGKA BARAT,25268,JEBUS,2873,6781,9654
24993,KEPULAUAN BANGKA BELITUNG,25245,BANGKA BARAT,25280,KELAPA,3832,11573,15405
24993,KEPULAUAN BANGKA BELITUNG,25245,BANGKA BARAT,25246,MUNTOK,6764,15251,22015
24993,KEPULAUAN BANGKA BELITUNG,25245,BANGKA BARAT,25305,PARITTIGA,2588,12202,14790
24993,KEPULAUAN BANGKA BELITUNG,25245,BANGKA BARAT,25254,SIMPANG TERITIP,3094,9840,12934
24993,KEPULAUAN BANGKA BELITUNG,25245,BANGKA BARAT,25295,TEMPILANG,3330,9069,12399
24993,KEPULAUAN BANGKA BELITUNG,25120,BANGKA SELATAN,25140,AIR GEGAS,4937,10700,15637
24993,KEPULAUAN BANGKA BELITUNG,25120,BANGKA SELATAN,83511,KEPULAUAN PONGOK,432,1771,2203
24993,KEPULAUAN BANGKA BELITUNG,25120,BANGKA SELATAN,25133,LEPAR PONGOK,1035,2578,3613
24993,KEPULAUAN BANGKA BELITUNG,25120,BANGKA SELATAN,25159,PAYUNG,3945,5554,9499
24993,KEPULAUAN BANGKA BELITUNG,25120,BANGKA SELATAN,25175,PULAUBESAR,1102,3247,4349
24993,KEPULAUAN BANGKA BELITUNG,25120,BANGKA SELATAN,25151,SIMPANG RIMBA,2378,7674,10052
24993,KEPULAUAN BANGKA BELITUNG,25120,BANGKA SELATAN,25121,TOBOALI,9492,20385,29877
24993,KEPULAUAN BANGKA BELITUNG,25120,BANGKA SELATAN,25169,TUKAK SADAI,1253,4326,5579
24993,KEPULAUAN BANGKA BELITUNG,25181,BANGKA TENGAH,25182,KOBA,5218,10397,15615
24993,KEPULAUAN BANGKA BELITUNG,25181,BANGKA TENGAH,25236,LUBUK BESAR,2621,8581,11202
24993,KEPULAUAN BANGKA BELITUNG,25181,BANGKA TENGAH,25228,NAMANG,2417,4033,6450
24993,KEPULAUAN BANGKA BELITUNG,25181,BANGKA TENGAH,25194,PANGKALAN BARU,4402,13618,18020
24993,KEPULAUAN BANGKA BELITUNG,25181,BANGKA TENGAH,25217,SIMPANG KATIS,3609,5884,9493
24993,KEPULAUAN BANGKA BELITUNG,25181,BANGKA TENGAH,25205,SUNGAI SELAN,3811,10194,14005
24993,KEPULAUAN BANGKA BELITUNG,25072,BELITUNG,25113,BADAU,0,0,0
24993,KEPULAUAN BANGKA BELITUNG,25072,BELITUNG,25086,MEMBALONG,0,0,0
24993,KEPULAUAN BANGKA BELITUNG,25072,BELITUNG,25099,SELAT NASIK,0,0,0
24993,KEPULAUAN BANGKA BELITUNG,25072,BELITUNG,25104,SIJUK,0,0,0
24993,KEPULAUAN BANGKA BELITUNG,25072,BELITUNG,25073,TANJUNG PANDAN,0,0,0
24993,KEPULAUAN BANGKA BELITUNG,25316,BELITUNG TIMUR,25347,DAMAR,1879,4620,6499
24993,KEPULAUAN BANGKA BELITUNG,25316,BELITUNG TIMUR,25335,DENDANG,1524,3909,5433
24993,KEPULAUAN BANGKA BELITUNG,25316,BELITUNG TIMUR,25327,GANTUNG,3460,9386,12846
24993,KEPULAUAN BANGKA BELITUNG,25316,BELITUNG TIMUR,25340,KELAPA KAMPIT,3709,6222,9931
24993,KEPULAUAN BANGKA BELITUNG,25316,BELITUNG TIMUR,25317,MANGGAR,5785,12291,18076
24993,KEPULAUAN BANGKA BELITUNG,25316,BELITUNG TIMUR,25358,SIMPANG PESAK,986,3364,4350
24993,KEPULAUAN BANGKA BELITUNG,25316,BELITUNG TIMUR,25353,SIMPANG RENGGIANG,1199,3025,4224
24993,KEPULAUAN BANGKA BELITUNG,25363,KOTA PANGKALPINANG,25364,BUKITINTAN,4901,10417,15318
24993,KEPULAUAN BANGKA BELITUNG,25363,KOTA PANGKALPINANG,83512,GABEK,5096,6291,11387
24993,KEPULAUAN BANGKA BELITUNG,25363,KOTA PANGKALPINANG,25398,GERUNGGANG,8347,6642,14989
24993,KEPULAUAN BANGKA BELITUNG,25363,KOTA PANGKALPINANG,83513,GIRIMAYA,2556,6631,9187
24993,KEPULAUAN BANGKA BELITUNG,25363,KOTA PANGKALPINANG,25377,PANGKAL BALAM,3542,5719,9261
24993,KEPULAUAN BANGKA BELITUNG,25363,KOTA PANGKALPINANG,25388,RANGKUI,6481,9323,15804
24993,KEPULAUAN BANGKA BELITUNG,25363,KOTA PANGKALPINANG,25372,TAMAN SARI,4880,4680,9560
25405,KEPULAUAN RIAU,25471,BINTAN,25522,BINTAN PESISIR,1111,2668,3779
25405,KEPULAUAN RIAU,25471,BINTAN,25477,BINTAN TIMUR,8196,11772,19968
25405,KEPULAUAN RIAU,25471,BINTAN,25482,BINTAN UTARA,4073,5479,9552
25405,KEPULAUAN RIAU,25471,BINTAN,25472,GUNUNG KIJANG,2001,4687,6688
25405,KEPULAUAN RIAU,25471,BINTAN,25517,MANTANG,944,1081,2025
25405,KEPULAUAN RIAU,25471,BINTAN,25527,SERI KUALA LOBAM,3175,4220,7395
25405,KEPULAUAN RIAU,25471,BINTAN,25495,TAMBELAN,945,1370,2315
25405,KEPULAUAN RIAU,25471,BINTAN,25504,TELOK SEBONG,2606,4966,7572
25405,KEPULAUAN RIAU,25471,BINTAN,25488,TELUK BINTAN,2081,3394,5475
25405,KEPULAUAN RIAU,25471,BINTAN,25512,TOAPAYA,1985,4026,6011
25405,KEPULAUAN RIAU,25533,KARIMUN,83516,BELAT,833,2161,2994
25405,KEPULAUAN RIAU,25533,KARIMUN,25572,BURU,1801,2289,4090
25405,KEPULAUAN RIAU,25533,KARIMUN,25592,DURAI,1184,1655,2839
25405,KEPULAUAN RIAU,25533,KARIMUN,25551,KARIMUN,7212,11466,18678
25405,KEPULAUAN RIAU,25533,KARIMUN,25542,KUNDUR,3604,9532,13136
25405,KEPULAUAN RIAU,25533,KARIMUN,25586,KUNDUR BARAT,2488,6027,8515
25405,KEPULAUAN RIAU,25533,KARIMUN,25577,KUNDUR UTARA,1636,3855,5491
25405,KEPULAUAN RIAU,25533,KARIMUN,25558,MERAL,6103,10932,17035
25405,KEPULAUAN RIAU,25533,KARIMUN,83514,MERAL BARAT,2673,3130,5803
25405,KEPULAUAN RIAU,25533,KARIMUN,25534,MORO,2902,6257,9159
25405,KEPULAUAN RIAU,25533,KARIMUN,25564,TEBING,4654,6377,11031
25405,KEPULAUAN RIAU,25533,KARIMUN,83515,UNGAR,753,1828,2581
25405,KEPULAUAN RIAU,25429,KEPULAUAN ANAMBAS,25459,JEMAJA,813,2073,2886
25405,KEPULAUAN RIAU,25429,KEPULAUAN ANAMBAS,25454,JEMAJA TIMUR,299,879,1178
25405,KEPULAUAN RIAU,25429,KEPULAUAN ANAMBAS,25433,PALMATAK,1582,4248,5830
25405,KEPULAUAN RIAU,25429,KEPULAUAN ANAMBAS,25430,SIANTAN,1505,3738,5243
25405,KEPULAUAN RIAU,25429,KEPULAUAN ANAMBAS,25447,SIANTAN SELATAN,493,1384,1877
25405,KEPULAUAN RIAU,25429,KEPULAUAN ANAMBAS,25467,SIANTAN TENGAH,369,1314,1683
25405,KEPULAUAN RIAU,25429,KEPULAUAN ANAMBAS,25443,SIANTAN TIMUR,407,1509,1916
25405,KEPULAUAN RIAU,25746,KOTA BATAM,25804,BATAM KOTA,31612,45129,76741
25405,KEPULAUAN RIAU,25746,KOTA BATAM,25818,BATU AJI,24713,33715,58428
25405,KEPULAUAN RIAU,25746,KOTA BATAM,25754,BATU AMPAR,11830,15001,26831
25405,KEPULAUAN RIAU,25746,KOTA BATAM,25747,BELAKANG PADANG,5232,4839,10071
25405,KEPULAUAN RIAU,25746,KOTA BATAM,25799,BENGKONG,22084,24017,46101
25405,KEPULAUAN RIAU,25746,KOTA BATAM,25772,BULANG,2299,3173,5472
25405,KEPULAUAN RIAU,25746,KOTA BATAM,25790,GALANG,3555,4248,7803
25405,KEPULAUAN RIAU,25746,KOTA BATAM,25779,LUBUK BAJA,11558,25337,36895
25405,KEPULAUAN RIAU,25746,KOTA BATAM,25767,NONGSA,13019,13796,26815
25405,KEPULAUAN RIAU,25746,KOTA BATAM,25811,SAGULUNG,33442,41770,75212
25405,KEPULAUAN RIAU,25746,KOTA BATAM,25785,SEI BEDUK,16320,21476,37796
25405,KEPULAUAN RIAU,25746,KOTA BATAM,25759,SEKUPANG,26582,24665,51247
25405,KEPULAUAN RIAU,25406,KOTA TANJUNGPINANG,25423,BUKIT BESTARI,10354,15397,25751
25405,KEPULAUAN RIAU,25406,KOTA TANJUNGPINANG,25407,TANJUNG PINANG BARAT,9135,14998,24133
25405,KEPULAUAN RIAU,25406,KOTA TANJUNGPINANG,25418,TANJUNG PINANG KOTA,2848,6745,9593
25405,KEPULAUAN RIAU,25406,KOTA TANJUNGPINANG,25412,TANJUNG PINANG TIMUR,15927,17881,33808
25405,KEPULAUAN RIAU,25683,LINGGA,25696,LINGGA,1868,3880,5748
25405,KEPULAUAN RIAU,25683,LINGGA,83518,LINGGA TIMUR,711,1352,2063
25405,KEPULAUAN RIAU,25683,LINGGA,25727,LINGGA UTARA,1757,3567,5324
25405,KEPULAUAN RIAU,25683,LINGGA,83519,SELAYAR,523,1168,1691
25405,KEPULAUAN RIAU,25683,LINGGA,25715,SENAYANG,2671,7350,10021
25405,KEPULAUAN RIAU,25683,LINGGA,25684,SINGKEP,4141,7582,11723
25405,KEPULAUAN RIAU,25683,LINGGA,25736,SINGKEP BARAT,1711,6401,8112
25405,KEPULAUAN RIAU,25683,LINGGA,83517,SINGKEP PESISIR,636,1643,2279
25405,KEPULAUAN RIAU,25597,NATUNA,25605,BUNGURAN BARAT,1195,3899,5094
25405,KEPULAUAN RIAU,25597,NATUNA,25673,BUNGURAN SELATAN,403,940,1343
25405,KEPULAUAN RIAU,25597,NATUNA,25669,BUNGURAN TENGAH,519,1160,1679
25405,KEPULAUAN RIAU,25597,NATUNA,25621,BUNGURAN TIMUR,3447,6025,9472
25405,KEPULAUAN RIAU,25597,NATUNA,25661,BUNGURAN TIMUR LAUT,717,1542,2259
25405,KEPULAUAN RIAU,25597,NATUNA,25628,BUNGURAN UTARA,445,1390,1835
25405,KEPULAUAN RIAU,25597,NATUNA,25598,MIDAI,684,1734,2418
25405,KEPULAUAN RIAU,25597,NATUNA,25646,PULAU LAUT,162,843,1005
25405,KEPULAUAN RIAU,25597,NATUNA,25650,PULAU TIGA,620,1661,2281
25405,KEPULAUAN RIAU,25597,NATUNA,25615,SERASAN,824,1427,2251
25405,KEPULAUAN RIAU,25597,NATUNA,25678,SERASAN TIMUR,582,787,1369
25405,KEPULAUAN RIAU,25597,NATUNA,25637,SUBI,358,964,1322
22328,LAMPUNG,24709,KOTA BANDAR LAMPUNG,83510,BUMI WARAS,9732,17938,27670
22328,LAMPUNG,24709,KOTA BANDAR LAMPUNG,83507,ENGGAL,7080,6082,13162
22328,LAMPUNG,24709,KOTA BANDAR LAMPUNG,83508,KEDAMAIAN,11341,13007,24348
22328,LAMPUNG,24709,KOTA BANDAR LAMPUNG,24710,KEDATON,13389,11950,25339
22328,LAMPUNG,24709,KOTA BANDAR LAMPUNG,24814,KEMILING,20159,13893,34052
22328,LAMPUNG,24709,KOTA BANDAR LAMPUNG,83504,LABUHAN RATU,12448,9195,21643
22328,LAMPUNG,24709,KOTA BANDAR LAMPUNG,83506,LANGKAPURA,10345,6788,17133
22328,LAMPUNG,24709,KOTA BANDAR LAMPUNG,24732,PANJANG,13157,21583,34740
22328,LAMPUNG,24709,KOTA BANDAR LAMPUNG,24796,RAJABASA,12873,8524,21397
22328,LAMPUNG,24709,KOTA BANDAR LAMPUNG,24806,SUKABUMI,14930,13529,28459
22328,LAMPUNG,24709,KOTA BANDAR LAMPUNG,24719,SUKARAME,16429,13325,29754
22328,LAMPUNG,24709,KOTA BANDAR LAMPUNG,24801,TANJUNG SENANG,12387,11279,23666
22328,LAMPUNG,24709,KOTA BANDAR LAMPUNG,24725,TANJUNGKARANG BARAT,15070,12050,27120
22328,LAMPUNG,24709,KOTA BANDAR LAMPUNG,24752,TANJUNGKARANG PUSAT,13571,11046,24617
22328,LAMPUNG,24709,KOTA BANDAR LAMPUNG,24740,TANJUNGKARANG TIMUR,9096,9084,18180
22328,LAMPUNG,24709,KOTA BANDAR LAMPUNG,24776,TELUKBETUNG BARAT,7144,8133,15277
22328,LAMPUNG,24709,KOTA BANDAR LAMPUNG,24764,TELUKBETUNG SELATAN,8678,11231,19909
22328,LAMPUNG,24709,KOTA BANDAR LAMPUNG,83509,TELUKBETUNG TIMUR,8894,11855,20749
22328,LAMPUNG,24709,KOTA BANDAR LAMPUNG,24785,TELUKBETUNG UTARA,12096,13208,25304
22328,LAMPUNG,24709,KOTA BANDAR LAMPUNG,83505,WAY HALIM,14706,16777,31483
22328,LAMPUNG,24822,KOTA METRO,24834,METRO BARAT,7103,7004,14107
22328,LAMPUNG,24822,KOTA METRO,24823,METRO PUSAT,13634,12560,26194
22328,LAMPUNG,24822,KOTA METRO,24845,METRO SELATAN,4363,4502,8865
22328,LAMPUNG,24822,KOTA METRO,24839,METRO TIMUR,10099,9804,19903
22328,LAMPUNG,24822,KOTA METRO,24829,METRO UTARA,6733,7972,14705
22328,LAMPUNG,23460,LAMPUNG BARAT,23684,AIR HITAM,1855,5112,6967
22328,LAMPUNG,23460,LAMPUNG BARAT,23505,BALIK BUKIT,9850,9071,18921
22328,LAMPUNG,23460,LAMPUNG BARAT,23727,BANDAR NEGERI SUOH,3554,12461,16015
22328,LAMPUNG,23460,LAMPUNG BARAT,23637,BANGKUNAT BELIMBING,6748,7624,14372
22328,LAMPUNG,23460,LAMPUNG BARAT,23561,BATU BRAK,4509,3365,7874
22328,LAMPUNG,23460,LAMPUNG BARAT,23716,BATU KETULIS,3145,4511,7656
22328,LAMPUNG,23460,LAMPUNG BARAT,23525,BELALAU,3214,4594,7808
22328,LAMPUNG,23460,LAMPUNG BARAT,23611,BENGKUNAT,1693,2637,4330
22328,LAMPUNG,23460,LAMPUNG BARAT,23621,GEDUNG SURIAN,3284,6243,9527
22328,LAMPUNG,23460,LAMPUNG BARAT,23584,KARYA PENGGAWA,2485,3268,5753
22328,LAMPUNG,23460,LAMPUNG BARAT,23695,KEBUN TEBU,3788,6998,10786
22328,LAMPUNG,23460,LAMPUNG BARAT,23651,KRUI SELATAN,1876,2190,4066
22328,LAMPUNG,23460,LAMPUNG BARAT,23597,LEMONG,2804,4201,7005
22328,LAMPUNG,23460,LAMPUNG BARAT,23673,LUMBOK SEMINUNG,1344,2767,4111
22328,LAMPUNG,23460,LAMPUNG BARAT,23627,NGAMBUR,2966,6534,9500
22328,LAMPUNG,23460,LAMPUNG BARAT,23706,PAGAR DEWA,4442,7097,11539
22328,LAMPUNG,23460,LAMPUNG BARAT,23461,PESISIR SELATAN,4192,7113,11305
22328,LAMPUNG,23460,LAMPUNG BARAT,23477,PESISIR TENGAH,4901,3958,8859
22328,LAMPUNG,23460,LAMPUNG BARAT,23486,PESISIR UTARA,2334,1998,4332
22328,LAMPUNG,23460,LAMPUNG BARAT,83871,PULAUPISANG,420,483,903
22328,LAMPUNG,23460,LAMPUNG BARAT,23546,SEKINCAU,4000,6367,10367
22328,LAMPUNG,23460,LAMPUNG BARAT,23573,SUKAU,5589,6182,11771
22328,LAMPUNG,23460,LAMPUNG BARAT,23518,SUMBER JAYA,5894,6786,12680
22328,LAMPUNG,23460,LAMPUNG BARAT,23552,SUOH,2539,8688,11227
22328,LAMPUNG,23460,LAMPUNG BARAT,23662,WAY KRUI,2098,2040,4138
22328,LAMPUNG,23460,LAMPUNG BARAT,23536,WAY TENONG,8031,7973,16004
22328,LAMPUNG,22605,LAMPUNG SELATAN,22846,BAKAUHENI,4849,6914,11763
22328,LAMPUNG,22605,LAMPUNG SELATAN,22815,CANDIPURO,10428,17781,28209
22328,LAMPUNG,22605,LAMPUNG SELATAN,22749,JATI AGUNG,23310,39079,62389
22328,LAMPUNG,22605,LAMPUNG SELATAN,22646,KALIANDA,27326,18077,45403
22328,LAMPUNG,22605,LAMPUNG SELATAN,22690,KATIBUNG,14360,19665,34025
22328,LAMPUNG,22605,LAMPUNG SELATAN,22771,KETAPANG,9411,16970,26381
22328,LAMPUNG,22605,LAMPUNG SELATAN,22830,MERBAU MATARAM,11085,15336,26421
22328,LAMPUNG,22605,LAMPUNG SELATAN,22606,NATAR,47475,48609,96084
22328,LAMPUNG,22605,LAMPUNG SELATAN,22727,PALAS,11593,18557,30150
22328,LAMPUNG,22605,LAMPUNG SELATAN,22704,PENENGAHAN,12876,8009,20885
22328,LAMPUNG,22605,LAMPUNG SELATAN,22799,RAJA BASA,6766,5739,12505
22328,LAMPUNG,22605,LAMPUNG SELATAN,22674,SIDOMULYO,13677,17155,30832
22328,LAMPUNG,22605,LAMPUNG SELATAN,22788,SRAGI,6015,10701,16716
22328,LAMPUNG,22605,LAMPUNG SELATAN,22629,TANJUNG BINTANG,18312,21523,39835
22328,LAMPUNG,22605,LAMPUNG SELATAN,22852,TANJUNG SARI,5253,11441,16694
22328,LAMPUNG,22605,LAMPUNG SELATAN,22870,WAY PANJI,3043,6742,9785
22328,LAMPUNG,22605,LAMPUNG SELATAN,22861,WAY SULAN,5586,5523,11109
22328,LAMPUNG,22875,LAMPUNG TENGAH,23175,ANAK RATU AJI,4765,4801,9566
22328,LAMPUNG,22875,LAMPUNG TENGAH,23121,ANAK TUHA,9261,10591,19852
22328,LAMPUNG,22875,LAMPUNG TENGAH,23080,BANDAR MATARAM,0,0,0
22328,LAMPUNG,22875,LAMPUNG TENGAH,23165,BANDAR SURABAYA,0,0,0
22328,LAMPUNG,22875,LAMPUNG TENGAH,22890,BANGUN REJO,13338,17207,30545
22328,LAMPUNG,22875,LAMPUNG TENGAH,23054,BEKRI,5992,7848,13840
22328,LAMPUNG,22875,LAMPUNG TENGAH,23151,BUMI NABUNG,6403,11524,17927
22328,LAMPUNG,22875,LAMPUNG TENGAH,23044,BUMI RATU NUBAN,0,0,0
22328,LAMPUNG,22875,LAMPUNG TENGAH,22921,GUNUNG SUGIH,21134,15244,36378
22328,LAMPUNG,22875,LAMPUNG TENGAH,22876,KALIREJO,0,0,0
22328,LAMPUNG,22875,LAMPUNG TENGAH,23144,KOTA GAJAH,0,0,0
22328,LAMPUNG,22875,LAMPUNG TENGAH,22906,PADANG RATU,11954,14615,26569
22328,LAMPUNG,22875,LAMPUNG TENGAH,23089,PUBIAN,0,0,0
22328,LAMPUNG,22875,LAMPUNG TENGAH,22952,PUNGGUR,10383,10495,20878
22328,LAMPUNG,22875,LAMPUNG TENGAH,23182,PUTRA RUMBIA,2984,7564,10548
22328,LAMPUNG,22875,LAMPUNG TENGAH,22988,RUMBIA,0,0,0
22328,LAMPUNG,22875,LAMPUNG TENGAH,23108,SELAGAI LINGGA,6962,10519,17481
22328,LAMPUNG,22875,LAMPUNG TENGAH,23134,SENDANG AGUNG,7971,11593,19564
22328,LAMPUNG,22875,LAMPUNG TENGAH,23063,SEPUTIH AGUNG,0,0,0
22328,LAMPUNG,22875,LAMPUNG TENGAH,22997,SEPUTIH BANYAK,10431,15373,25804
22328,LAMPUNG,22875,LAMPUNG TENGAH,23009,SEPUTIH MATARAM,0,0,0
22328,LAMPUNG,22875,LAMPUNG TENGAH,22973,SEPUTIH RAMAN,11382,15761,27143
22328,LAMPUNG,22875,LAMPUNG TENGAH,23022,SEPUTIH SURABAYA,0,0,0
22328,LAMPUNG,22875,LAMPUNG TENGAH,22962,TERBANGGI BESAR,30702,28699,59401
22328,LAMPUNG,22875,LAMPUNG TENGAH,23036,TERUSAN NUNYAI,16298,8448,24746
22328,LAMPUNG,22875,LAMPUNG TENGAH,22937,TRIMURJO,14700,15086,29786
22328,LAMPUNG,22875,LAMPUNG TENGAH,23073,WAY PANGUBUAN,0,0,0
22328,LAMPUNG,22875,LAMPUNG TENGAH,23158,WAY SEPUTIH,4372,5452,9824
22328,LAMPUNG,24202,LAMPUNG TIMUR,24396,BANDAR SRIBHAWONO,8520,16946,25466
22328,LAMPUNG,24202,LAMPUNG TIMUR,24278,BATANGHARI,14832,17860,32692
22328,LAMPUNG,24202,LAMPUNG TIMUR,24375,BATANGHARI NUBAN,13191,11497,24688
22328,LAMPUNG,24202,LAMPUNG TIMUR,24458,BRAJA SELEBAH,4243,7450,11693
22328,LAMPUNG,24202,LAMPUNG TIMUR,24389,BUMI AGUNG,4028,6537,10565
22328,LAMPUNG,24202,LAMPUNG TIMUR,24419,GUNUNG PELINDUNG,5656,4853,10509
22328,LAMPUNG,24202,LAMPUNG TIMUR,24233,JABUNG,14974,11938,26912
22328,LAMPUNG,24202,LAMPUNG TIMUR,24221,LABUHAN MARINGGAI,15344,17773,33117
22328,LAMPUNG,24202,LAMPUNG TIMUR,24446,LABUHAN RATU,9509,14686,24195
22328,LAMPUNG,24202,LAMPUNG TIMUR,24475,MARGA SEKAMPUNG,5634,9094,14728
22328,LAMPUNG,24202,LAMPUNG TIMUR,24345,MARGA TIGA,9349,15063,24412
22328,LAMPUNG,24202,LAMPUNG TIMUR,24404,MATARAM BARU,7243,6867,14110
22328,LAMPUNG,24202,LAMPUNG TIMUR,24412,MELINTING,7092,6258,13350
22328,LAMPUNG,24202,LAMPUNG TIMUR,24337,METRO KIBANG,3696,8757,12453
22328,LAMPUNG,24202,LAMPUNG TIMUR,24425,PASIR SAKTI,7267,11532,18799
22328,LAMPUNG,24202,LAMPUNG TIMUR,24249,PEKALONGAN,12982,14914,27896
22328,LAMPUNG,24202,LAMPUNG TIMUR,24312,PURBOLINGGO,11947,12203,24150
22328,LAMPUNG,24202,LAMPUNG TIMUR,24325,RAMAN UTARA,8379,13592,21971
22328,LAMPUNG,24202,LAMPUNG TIMUR,24260,SEKAMPUNG,13038,22103,35141
22328,LAMPUNG,24202,LAMPUNG TIMUR,24359,SEKAMPUNG UDIK,12570,25441,38011
22328,LAMPUNG,24202,LAMPUNG TIMUR,24203,SUKADANA,16048,20971,37019
22328,LAMPUNG,24202,LAMPUNG TIMUR,24434,WAWAY KARYA,7262,11813,19075
22328,LAMPUNG,24202,LAMPUNG TIMUR,24466,WAY BUNGUR,6184,6650,12834
22328,LAMPUNG,24202,LAMPUNG TIMUR,24296,WAY JEPARA,11540,16469,28009
22328,LAMPUNG,23189,LAMPUNG UTARA,23258,ABUNG BARAT,6751,3720,10471
22328,LAMPUNG,23189,LAMPUNG UTARA,23444,ABUNG KUNANG,3602,1725,5327
22328,LAMPUNG,23189,LAMPUNG UTARA,23413,ABUNG PEKURUN,3630,2241,5871
22328,LAMPUNG,23189,LAMPUNG UTARA,23273,ABUNG SELATAN,13790,12211,26001
22328,LAMPUNG,23189,LAMPUNG UTARA,23351,ABUNG SEMULI,6774,6828,13602
22328,LAMPUNG,23189,LAMPUNG UTARA,23359,ABUNG SURAKARTA,7638,7672,15310
22328,LAMPUNG,23189,LAMPUNG UTARA,23330,ABUNG TENGAH,4872,4274,9146
22328,LAMPUNG,23189,LAMPUNG UTARA,23245,ABUNG TIMUR,10640,9879,20519
22328,LAMPUNG,23189,LAMPUNG UTARA,23342,ABUNG TINGGI,6167,2888,9055
22328,LAMPUNG,23189,LAMPUNG UTARA,23452,BLAMBANGAN PAGAR,5002,5087,10089
22328,LAMPUNG,23189,LAMPUNG UTARA,23190,BUKIT KEMUNING,12022,8881,20903
22328,LAMPUNG,23189,LAMPUNG UTARA,23381,BUNGA MAYANG,9289,9801,19090
22328,LAMPUNG,23189,LAMPUNG UTARA,23393,HULU SUNGKAI,4298,3246,7544
22328,LAMPUNG,23189,LAMPUNG UTARA,23199,KOTABUMI,17105,9815,26920
22328,LAMPUNG,23189,LAMPUNG UTARA,23315,KOTABUMI SELATAN,23409,10075,33484
22328,LAMPUNG,23189,LAMPUNG UTARA,23306,KOTABUMI UTARA,8436,9019,17455
22328,LAMPUNG,23189,LAMPUNG UTARA,23369,MUARA SUNGKAI,4600,3659,8259
22328,LAMPUNG,23189,LAMPUNG UTARA,23433,SUNGKAI BARAT,3889,1979,5868
22328,LAMPUNG,23189,LAMPUNG UTARA,23423,SUNGKAI JAYA,2863,1477,4340
22328,LAMPUNG,23189,LAMPUNG UTARA,23213,SUNGKAI SELATAN,7158,4587,11745
22328,LAMPUNG,23189,LAMPUNG UTARA,23404,SUNGKAI TENGAH,3722,4817,8539
22328,LAMPUNG,23189,LAMPUNG UTARA,23290,SUNGKAI UTARA,9410,8598,18008
22328,LAMPUNG,23189,LAMPUNG UTARA,23225,TANJUNG RAJA,10734,6405,17139
22328,LAMPUNG,22439,MESUJI,22440,MESUJI,3073,6557,9630
22328,LAMPUNG,22439,MESUJI,22450,MESUJI TIMUR,6093,11419,17512
22328,LAMPUNG,22439,MESUJI,22500,PANCA JAYA,3828,5505,9333
22328,LAMPUNG,22439,MESUJI,22464,RAWA JITU UTARA,6025,7080,13105
22328,LAMPUNG,22439,MESUJI,22490,SIMPANG PEMATANG,8152,5796,13948
22328,LAMPUNG,22439,MESUJI,22508,TANJUNG RAYA,9256,11694,20950
22328,LAMPUNG,22439,MESUJI,22476,WAY SERDANG,8697,14530,23227
22328,LAMPUNG,24850,PESAWARAN,24851,GEDONG TATAAN,29078,23615,52693
22328,LAMPUNG,24850,PESAWARAN,24972,KEDONDONG,9382,8520,17902
22328,LAMPUNG,24850,PESAWARAN,83501,MARGA PUNDUH,3949,4188,8137
22328,LAMPUNG,24850,PESAWARAN,24871,NEGERI KATON,16088,19953,36041
22328,LAMPUNG,24850,PESAWARAN,24925,PADANG CERMIN,18576,29941,48517
22328,LAMPUNG,24850,PESAWARAN,24949,PUNDUH PIDADA,3152,4742,7894
22328,LAMPUNG,24850,PESAWARAN,24892,TEGINENENG,12054,18464,30518
22328,LAMPUNG,24850,PESAWARAN,83502,WAY KHILAU,8782,5561,14343
22328,LAMPUNG,24850,PESAWARAN,24908,WAY LIMA,12499,8331,20830
22328,LAMPUNG,22329,PRINGSEWU,22416,ADILUWIH,8304,10223,18527
22328,LAMPUNG,22329,PRINGSEWU,22360,AMBARAWA,8945,10042,18987
22328,LAMPUNG,22329,PRINGSEWU,22406,BANYUMAS,5070,5724,10794
22328,LAMPUNG,22329,PRINGSEWU,22344,GADING REJO,21132,21505,42637
22328,LAMPUNG,22329,PRINGSEWU,22381,PAGELARAN,14214,12974,27188
22328,LAMPUNG,22329,PRINGSEWU,83503,PAGELARAN UTARA,3380,4025,7405
22328,LAMPUNG,22329,PRINGSEWU,22368,PARDASUKA,9227,9407,18634
22328,LAMPUNG,22329,PRINGSEWU,22330,PRINGSEWU,20392,23527,43919
22328,LAMPUNG,22329,PRINGSEWU,22425,SUKOHARJO,12013,12248,24261
22328,LAMPUNG,23903,TANGGAMUS,24175,AIR NANINGAN,6446,9399,15845
22328,LAMPUNG,23903,TANGGAMUS,24164,BANDAR NEGERI SEMUONG,4143,2959,7102
22328,LAMPUNG,23903,TANGGAMUS,24185,BULOK,5741,5552,11293
22328,LAMPUNG,23903,TANGGAMUS,23983,CUKUH BALAK,6671,5921,12592
22328,LAMPUNG,23903,TANGGAMUS,24132,GISTING,11552,10386,21938
22328,LAMPUNG,23903,TANGGAMUS,24141,GUNUNG ALIP,7502,2452,9954
22328,LAMPUNG,23903,TANGGAMUS,24094,KLUMBAYAN,3312,3053,6365
22328,LAMPUNG,23903,TANGGAMUS,24195,KLUMBAYAN BARAT,2504,4011,6515
22328,LAMPUNG,23903,TANGGAMUS,23904,KOTA AGUNG,13219,8682,21901
22328,LAMPUNG,23903,TANGGAMUS,24103,KOTA AGUNG BARAT,7870,2479,10349
22328,LAMPUNG,23903,TANGGAMUS,24120,KOTA AGUNG TIMUR,5999,3851,9850
22328,LAMPUNG,23903,TANGGAMUS,24153,LIMAU,5774,5649,11423
22328,LAMPUNG,23903,TANGGAMUS,24080,PEMATANG SAWA,4187,5017,9204
22328,LAMPUNG,23903,TANGGAMUS,24002,PUGUNG,17210,12849,30059
22328,LAMPUNG,23903,TANGGAMUS,23964,PULAU PANGGUNG,10590,8366,18956
22328,LAMPUNG,23903,TANGGAMUS,24029,SEMAKA,9700,10814,20514
22328,LAMPUNG,23903,TANGGAMUS,24050,SUMBER REJO,7162,11835,18997
22328,LAMPUNG,23903,TANGGAMUS,23920,TALANG PADANG,15246,8169,23415
22328,LAMPUNG,23903,TANGGAMUS,24064,ULU BELU,8822,15824,24646
22328,LAMPUNG,23903,TANGGAMUS,23940,WONOSOBO,9505,8407,17912
22328,LAMPUNG,23737,TULANG BAWANG,23760,BANJAR AGUNG,9065,11866,20931
22328,LAMPUNG,23737,TULANG BAWANG,23879,BANJAR BARU,4256,3655,7911
22328,LAMPUNG,23737,TULANG BAWANG,23820,BANJAR MARGO,6913,11789,18702
22328,LAMPUNG,23737,TULANG BAWANG,23867,DENTE TELADAS,11203,16059,27262
22328,LAMPUNG,23737,TULANG BAWANG,23749,GEDUNG AJI,2963,4177,7140
22328,LAMPUNG,23737,TULANG BAWANG,23862,GEDUNG AJI BARU,5159,5937,11096
22328,LAMPUNG,23737,TULANG BAWANG,23773,GEDUNG MENENG,12145,8936,21081
22328,LAMPUNG,23737,TULANG BAWANG,23738,MENGGALA,13801,8094,21895
22328,LAMPUNG,23737,TULANG BAWANG,23890,MENGGALA TIMUR,4136,4044,8180
22328,LAMPUNG,23737,TULANG BAWANG,23853,MERAKSA AJI,2683,4573,7256
22328,LAMPUNG,23737,TULANG BAWANG,23843,PENAWAR AJI,2945,6682,9627
22328,LAMPUNG,23737,TULANG BAWANG,23796,PENAWAR TAMA,5193,10065,15258
22328,LAMPUNG,23737,TULANG BAWANG,23785,RAWA JITU SELATAN,7308,8111,15419
22328,LAMPUNG,23737,TULANG BAWANG,23811,RAWA JITU TIMUR,3723,3535,7258
22328,LAMPUNG,23737,TULANG BAWANG,23833,RAWA PITU,3671,5030,8701
22328,LAMPUNG,22522,TULANG BAWANG BARAT,22587,GUNUNG AGUNG,6252,11866,18118
22328,LAMPUNG,22522,TULANG BAWANG BARAT,22548,GUNUNG TERANG,6907,11290,18197
22328,LAMPUNG,22522,TULANG BAWANG BARAT,22560,LAMBU KIBANG,5716,7496,13212
22328,LAMPUNG,22522,TULANG BAWANG BARAT,22581,PAGAR DEWA,1567,1846,3413
22328,LAMPUNG,22522,TULANG BAWANG BARAT,22523,TULANG BAWANG TENGAH,23535,22445,45980
22328,LAMPUNG,22522,TULANG BAWANG BARAT,22538,TULANG BAWANG UDIK,9087,8880,17967
22328,LAMPUNG,22522,TULANG BAWANG BARAT,22569,TUMIJAJAR,12035,12019,24054
22328,LAMPUNG,22522,TULANG BAWANG BARAT,22598,WAY KENANGA,3948,7789,11737
22328,LAMPUNG,24484,WAY KANAN,24573,BAHUGA,2582,3552,6134
22328,LAMPUNG,24484,WAY KANAN,24529,BANJIT,10766,14072,24838
22328,LAMPUNG,24484,WAY KANAN,24550,BARADATU,10836,10975,21811
22328,LAMPUNG,24484,WAY KANAN,24485,BLAMBANGAN UMPU,15627,17377,33004
22328,LAMPUNG,24484,WAY KANAN,24691,BUAY BAHUGA,6544,4884,11428
22328,LAMPUNG,24484,WAY KANAN,24699,BUMI AGUNG,7544,7178,14722
22328,LAMPUNG,24484,WAY KANAN,24645,GUNUNG LABUHAN,7220,7314,14534
22328,LAMPUNG,24484,WAY KANAN,24510,KASUI,8025,8924,16949
22328,LAMPUNG,24484,WAY KANAN,24665,NEGARA BATIN,6849,12418,19267
22328,LAMPUNG,24484,WAY KANAN,24602,NEGERI AGUNG,8245,12719,20964
22328,LAMPUNG,24484,WAY KANAN,24680,NEGERI BESAR,3560,7351,10911
22328,LAMPUNG,24484,WAY KANAN,24582,PAKUAN RATU,8196,15577,23773
22328,LAMPUNG,24484,WAY KANAN,24634,REBANG TANGKAS,4776,6773,11549
22328,LAMPUNG,24484,WAY KANAN,24621,WAY TUBA,6969,5816,12785
76096,MALUKU,76651,BURU,76664,AIR BUAYA,3310,2654,5964
76096,MALUKU,76651,BURU,76702,BATABUAL,2898,2078,4976
76096,MALUKU,76651,BURU,83822,FENA LEISELA,0,0,0
76096,MALUKU,76651,BURU,83826,LILIALY,3961,1376,5337
76096,MALUKU,76651,BURU,83823,LOLONG GUBA,3867,2147,6014
76096,MALUKU,76651,BURU,76652,NAMLEA,13529,4749,18278
76096,MALUKU,76651,BURU,83825,TELUK KAIELY,1790,617,2407
76096,MALUKU,76651,BURU,76673,WAEAPO,3994,2496,6490
76096,MALUKU,76651,BURU,83824,WAELATA,3958,2549,6507
76096,MALUKU,76651,BURU,76692,WAPLAU,3621,2139,5760
76096,MALUKU,76223,BURU SELATAN,76244,AMBALAU,0,0,0
76096,MALUKU,76223,BURU SELATAN,83857,FENA FAFAN,0,0,0
76096,MALUKU,76223,BURU SELATAN,76252,KEPALA MADAN,0,0,0
76096,MALUKU,76223,BURU SELATAN,76263,LEKSULA,0,0,0
76096,MALUKU,76223,BURU SELATAN,76224,NAMROLE,0,0,0
76096,MALUKU,76223,BURU SELATAN,76235,WAESAMA,0,0,0
76096,MALUKU,76868,KEPULAUAN ARU,76886,ARU SELATAN,764,2512,3276
76096,MALUKU,76868,KEPULAUAN ARU,76982,ARU SELATAN TIMUR,698,1376,2074
76096,MALUKU,76868,KEPULAUAN ARU,83844,ARU SELATAN UTARA,593,1478,2071
76096,MALUKU,76868,KEPULAUAN ARU,76906,ARU TENGAH,1244,4924,6168
76096,MALUKU,76868,KEPULAUAN ARU,76974,ARU TENGAH SELATAN,1040,1647,2687
76096,MALUKU,76868,KEPULAUAN ARU,76960,ARU TENGAH TIMUR,630,1622,2252
76096,MALUKU,76868,KEPULAUAN ARU,76930,ARU UTARA,982,1936,2918
76096,MALUKU,76868,KEPULAUAN ARU,83842,ARU UTARA TIMUR BATULEY,1112,1117,2229
76096,MALUKU,76995,KOTA AMBON,77025,BAGUALA,8360,18007,26367
76096,MALUKU,76995,KOTA AMBON,77042,LEITIMUR SELATAN,622,4502,5124
76096,MALUKU,76995,KOTA AMBON,76996,NUSANIWE,15705,32910,48615
76096,MALUKU,76995,KOTA AMBON,77010,SIRIMAU,41477,34658,76135
76096,MALUKU,76995,KOTA AMBON,77033,TELUK AMBON,9972,10667,20639
76096,MALUKU,77051,KOTA TUAL,83858,KUR SELATAN,0,0,0
76096,MALUKU,77051,KOTA TUAL,77061,PULAU DULLAH SELATAN,0,0,0
76096,MALUKU,77051,KOTA TUAL,77052,PULAU DULLAH UTARA,0,0,0
76096,MALUKU,77051,KOTA TUAL,77067,TAYANDO TAM,0,0,0
76096,MALUKU,76097,MALUKU BARAT DAYA,76111,DAMER,738,1964,2702
76096,MALUKU,76097,MALUKU BARAT DAYA,76119,MNDONA HIERA,430,2366,2796
76096,MALUKU,76097,MALUKU BARAT DAYA,76098,MOA LAKOR,1369,4168,5537
76096,MALUKU,76097,MALUKU BARAT DAYA,76215,PULAU LETI,1399,2543,3942
76096,MALUKU,76097,MALUKU BARAT DAYA,76178,WETAR,1628,2919,4547
76096,MALUKU,76284,MALUKU TENGAH,76285,AMAHAI,0,0,0
76096,MALUKU,76284,MALUKU TENGAH,76347,BANDA,0,0,0
76096,MALUKU,76284,MALUKU TENGAH,76437,KOTA MASOHI,0,0,0
76096,MALUKU,76284,MALUKU TENGAH,76417,LEIHITU,0,0,0
76096,MALUKU,76284,MALUKU TENGAH,76464,LEIHITU BARAT,0,0,0
76096,MALUKU,76284,MALUKU TENGAH,76429,NUSA LAUT,0,0,0
76096,MALUKU,76284,MALUKU TENGAH,76398,PULAU HARUKU,0,0,0
76096,MALUKU,76284,MALUKU TENGAH,76410,SALAHUTU,0,0,0
76096,MALUKU,76284,MALUKU TENGAH,76381,SAPARUA,0,0,0
76096,MALUKU,76284,MALUKU TENGAH,83815,SAPARUA TIMUR,0,0,0
76096,MALUKU,76284,MALUKU TENGAH,76315,SERAM UTARA,0,0,0
76096,MALUKU,76284,MALUKU TENGAH,76443,SERAM UTARA BARAT,0,0,0
76096,MALUKU,76284,MALUKU TENGAH,83814,SERAM UTARA TIMUR KOBI,0,0,0
76096,MALUKU,76284,MALUKU TENGAH,83813,SERAM UTARA TIMUR SETI,0,0,0
76096,MALUKU,76284,MALUKU TENGAH,76360,TEHORU,0,0,0
76096,MALUKU,76284,MALUKU TENGAH,76456,TELUK ELPAPUTIH,0,0,0
76096,MALUKU,76284,MALUKU TENGAH,83812,TELUTIH,0,0,0
76096,MALUKU,76284,MALUKU TENGAH,76297,TEON NILA SERUA,0,0,0
76096,MALUKU,76470,MALUKU TENGGARA,76494,KEI BESAR,3483,8115,11598
76096,MALUKU,76470,MALUKU TENGGARA,76516,KEI BESAR SELATAN,2491,2436,4927
76096,MALUKU,76470,MALUKU TENGGARA,76531,KEI BESAR UTARA TIMUR,2388,3067,5455
76096,MALUKU,76470,MALUKU TENGGARA,76471,KEI KECIL,5888,14111,19999
76096,MALUKU,76470,MALUKU TENGGARA,76559,KEI KECIL BARAT,340,2955,3295
76096,MALUKU,76470,MALUKU TENGGARA,76545,KEI KECIL TIMUR,3354,3245,6599
76096,MALUKU,76568,MALUKU TENGGARA BARAT,76635,KORMOMOLIN,0,0,0
76096,MALUKU,76568,MALUKU TENGGARA BARAT,83821,MOLU MARU,0,0,0
76096,MALUKU,76568,MALUKU TENGGARA BARAT,76645,NIRUNMAS,0,0,0
76096,MALUKU,76568,MALUKU TENGGARA BARAT,76581,SELARU,0,0,0
76096,MALUKU,76568,MALUKU TENGGARA BARAT,76569,TANIMBAR SELATAN,0,0,0
76096,MALUKU,76568,MALUKU TENGGARA BARAT,76606,TANIMBAR UTARA,0,0,0
76096,MALUKU,76568,MALUKU TENGGARA BARAT,76597,WER MAKTIAN,0,0,0
76096,MALUKU,76568,MALUKU TENGGARA BARAT,76588,WER TAMRIAN,0,0,0
76096,MALUKU,76568,MALUKU TENGGARA BARAT,76622,WUAR LABOBAR,0,0,0
76096,MALUKU,76568,MALUKU TENGGARA BARAT,76615,YARU,0,0,0
76096,MALUKU,76771,SERAM BAGIAN BARAT,83836,AMALATU,5061,3497,8558
76096,MALUKU,76771,SERAM BAGIAN BARAT,83841,ELPAPUTIH,605,1607,2212
76096,MALUKU,76771,SERAM BAGIAN BARAT,76850,HUAMUAL,0,0,0
76096,MALUKU,76771,SERAM BAGIAN BARAT,91360,HUAMUAL BELAKANG,8647,5142,13789
76096,MALUKU,76771,SERAM BAGIAN BARAT,83837,INAMOSOL,0,0,0
76096,MALUKU,76771,SERAM BAGIAN BARAT,76772,KAIRATU,208,208,416
76096,MALUKU,76771,SERAM BAGIAN BARAT,83838,KAIRATU BARAT,0,0,0
76096,MALUKU,76771,SERAM BAGIAN BARAT,83839,KEPULAUAN MANIPA,3365,1261,4626
76096,MALUKU,76771,SERAM BAGIAN BARAT,76802,SERAM BARAT,0,0,0
76096,MALUKU,76771,SERAM BAGIAN BARAT,76815,TANIWEL,3237,3580,6817
76096,MALUKU,76771,SERAM BAGIAN BARAT,83840,TANIWEL TIMUR,1231,1830,3061
76096,MALUKU,76708,SERAM BAGIAN TIMUR,76709,BULA,0,0,0
76096,MALUKU,76708,SERAM BAGIAN TIMUR,83832,BULA BARAT,0,0,0
76096,MALUKU,76708,SERAM BAGIAN TIMUR,83831,GOROM TIMUR,0,0,0
76096,MALUKU,76708,SERAM BAGIAN TIMUR,83833,KIAN DARAT,0,0,0
76096,MALUKU,76708,SERAM BAGIAN TIMUR,83828,KILMURY,0,0,0
76096,MALUKU,76708,SERAM BAGIAN TIMUR,76741,PULAU GORONG,0,0,0
76096,MALUKU,76708,SERAM BAGIAN TIMUR,83829,PULAU PANJANG,0,0,0
76096,MALUKU,76708,SERAM BAGIAN TIMUR,76719,SERAM TIMUR,0,0,0
76096,MALUKU,76708,SERAM BAGIAN TIMUR,83834,SIRITAUN WIDA TIMUR,0,0,0
76096,MALUKU,76708,SERAM BAGIAN TIMUR,83827,SIWALALAT,0,0,0
76096,MALUKU,76708,SERAM BAGIAN TIMUR,83835,TELUK WARU,0,0,0
76096,MALUKU,76708,SERAM BAGIAN TIMUR,83830,TEOR,0,0,0
76096,MALUKU,76708,SERAM BAGIAN TIMUR,76763,TUTUK TOLU,0,0,0
76096,MALUKU,76708,SERAM BAGIAN TIMUR,76753,WAKATE,0,0,0
76096,MALUKU,76708,SERAM BAGIAN TIMUR,76730,WERINAMA,0,0,0
77085,MALUKU UTARA,77155,HALMAHERA BARAT,77209,IBU,3183,2284,5467
77085,MALUKU UTARA,77155,HALMAHERA BARAT,77280,IBU SELATAN,2519,3094,5613
77085,MALUKU UTARA,77155,HALMAHERA BARAT,77266,IBU UTARA,1816,2651,4467
77085,MALUKU UTARA,77155,HALMAHERA BARAT,77156,JAILOLO,8332,6946,15278
77085,MALUKU UTARA,77155,HALMAHERA BARAT,77240,JAILOLO SELATAN,4184,3408,7592
77085,MALUKU UTARA,77155,HALMAHERA BARAT,77259,JAILOLO TIMUR,0,0,0
77085,MALUKU UTARA,77155,HALMAHERA BARAT,77186,LOLODA,2455,3894,6349
77085,MALUKU UTARA,77155,HALMAHERA BARAT,77223,SAHU,2319,3286,5605
77085,MALUKU UTARA,77155,HALMAHERA BARAT,77294,SAHU TIMUR,1501,3227,4728
77085,MALUKU UTARA,77578,HALMAHERA SELATAN,77664,BACAN,4538,3794,8332
77085,MALUKU UTARA,77578,HALMAHERA SELATAN,77679,BACAN BARAT,1603,804,2407
77085,MALUKU UTARA,77578,HALMAHERA SELATAN,77714,BACAN BARAT UTARA,0,0,0
77085,MALUKU UTARA,77578,HALMAHERA SELATAN,77743,BACAN SELATAN,0,0,0
77085,MALUKU UTARA,77578,HALMAHERA SELATAN,77653,BACAN TIMUR,0,0,0
77085,MALUKU UTARA,77578,HALMAHERA SELATAN,77777,BACAN TIMUR SELATAN,1834,1245,3079
77085,MALUKU UTARA,77578,HALMAHERA SELATAN,77785,BACAN TIMUR TENGAH,2572,1502,4074
77085,MALUKU UTARA,77578,HALMAHERA SELATAN,77623,GANE BARAT,0,0,0
77085,MALUKU UTARA,77578,HALMAHERA SELATAN,77793,GANE BARAT SELATAN,0,0,0
77085,MALUKU UTARA,77578,HALMAHERA SELATAN,77802,GANE BARAT UTARA,2295,948,3243
77085,MALUKU UTARA,77578,HALMAHERA SELATAN,77610,GANE TIMUR,2097,2460,4557
77085,MALUKU UTARA,77578,HALMAHERA SELATAN,77823,GANE TIMUR SELATAN,0,0,0
77085,MALUKU UTARA,77578,HALMAHERA SELATAN,77829,GANE TIMUR TENGAH,0,0,0
77085,MALUKU UTARA,77578,HALMAHERA SELATAN,77723,KASIRUTA BARAT,0,0,0
77085,MALUKU UTARA,77578,HALMAHERA SELATAN,77734,KASIRUTA TIMUR,1045,1073,2118
77085,MALUKU UTARA,77578,HALMAHERA SELATAN,77595,KAYOA,3094,1459,4553
77085,MALUKU UTARA,77578,HALMAHERA SELATAN,77695,KAYOA BARAT,1667,689,2356
77085,MALUKU UTARA,77578,HALMAHERA SELATAN,77700,KAYOA SELATAN,1711,1448,3159
77085,MALUKU UTARA,77578,HALMAHERA SELATAN,77707,KAYOA UTARA,1172,648,1820
77085,MALUKU UTARA,77578,HALMAHERA SELATAN,77754,KEPULAUAN BOTANGLOMANG,2122,1619,3741
77085,MALUKU UTARA,77578,HALMAHERA SELATAN,77815,KEPULAUAN JORONGA,1981,1021,3002
77085,MALUKU UTARA,77578,HALMAHERA SELATAN,77687,MAKIAN BARAT,1925,405,2330
77085,MALUKU UTARA,77578,HALMAHERA SELATAN,77763,MANDIOLI SELATAN,1612,1124,2736
77085,MALUKU UTARA,77578,HALMAHERA SELATAN,77770,MANDIOLI UTARA,0,0,0
77085,MALUKU UTARA,77578,HALMAHERA SELATAN,77643,OBI,3631,3040,6671
77085,MALUKU UTARA,77578,HALMAHERA SELATAN,77838,OBI BARAT,0,0,0
77085,MALUKU UTARA,77578,HALMAHERA SELATAN,77634,OBI SELATAN,0,0,0
77085,MALUKU UTARA,77578,HALMAHERA SELATAN,77845,OBI TIMUR,0,0,0
77085,MALUKU UTARA,77578,HALMAHERA SELATAN,77850,OBI UTARA,0,0,0
77085,MALUKU UTARA,77578,HALMAHERA SELATAN,77579,PULAU MAKIAN,4944,3019,7963
77085,MALUKU UTARA,77311,HALMAHERA TENGAH,77322,PATANI,1260,834,2094
77085,MALUKU UTARA,77311,HALMAHERA TENGAH,83860,PATANI BARAT,1163,1006,2169
77085,MALUKU UTARA,77311,HALMAHERA TENGAH,77355,PATANI UTARA,3074,3098,6172
77085,MALUKU UTARA,77311,HALMAHERA TENGAH,77332,PULAU GEBE,1510,1291,2801
77085,MALUKU UTARA,77311,HALMAHERA TENGAH,77312,WEDA,1581,1949,3530
77085,MALUKU UTARA,77311,HALMAHERA TENGAH,77347,WEDA SELATAN,1230,1594,2824
77085,MALUKU UTARA,77311,HALMAHERA TENGAH,83859,WEDA TENGAH,985,1028,2013
77085,MALUKU UTARA,77311,HALMAHERA TENGAH,77339,WEDA UTARA,1704,2341,4045
77085,MALUKU UTARA,77956,HALMAHERA TIMUR,78034,KOTA MABA,3253,2481,5734
77085,MALUKU UTARA,77956,HALMAHERA TIMUR,77964,MABA,2159,2405,4564
77085,MALUKU UTARA,77956,HALMAHERA TIMUR,77972,MABA SELATAN,1693,1633,3326
77085,MALUKU UTARA,77956,HALMAHERA TIMUR,78017,MABA TENGAH,1331,1579,2910
77085,MALUKU UTARA,77956,HALMAHERA TIMUR,78026,MABA UTARA,1768,2110,3878
77085,MALUKU UTARA,77956,HALMAHERA TIMUR,77957,WASILE,2742,2096,4838
77085,MALUKU UTARA,77956,HALMAHERA TIMUR,77979,WASILE SELATAN,3461,3460,6921
77085,MALUKU UTARA,77956,HALMAHERA TIMUR,77994,WASILE TENGAH,1441,1283,2724
77085,MALUKU UTARA,77956,HALMAHERA TIMUR,78010,WASILE TIMUR,3120,1620,4740
77085,MALUKU UTARA,77956,HALMAHERA TIMUR,78003,WASILE UTARA,896,1485,2381
77085,MALUKU UTARA,77364,HALMAHERA UTARA,77365,GALELA,3018,741,3759
77085,MALUKU UTARA,77364,HALMAHERA UTARA,77489,GALELA BARAT,2797,2132,4929
77085,MALUKU UTARA,77364,HALMAHERA UTARA,77512,GALELA SELATAN,3011,1278,4289
77085,MALUKU UTARA,77364,HALMAHERA UTARA,77499,GALELA UTARA,0,0,0
77085,MALUKU UTARA,77364,HALMAHERA UTARA,77398,KAO,0,0,0
77085,MALUKU UTARA,77364,HALMAHERA UTARA,77544,KAO BARAT,1287,3220,4507
77085,MALUKU UTARA,77364,HALMAHERA UTARA,77566,KAO TELUK,2113,1408,3521
77085,MALUKU UTARA,77364,HALMAHERA UTARA,77531,KAO UTARA,0,0,0
77085,MALUKU UTARA,77364,HALMAHERA UTARA,77520,LOLODA KEPULAUAN,1922,1435,3357
77085,MALUKU UTARA,77364,HALMAHERA UTARA,77436,LOLODA UTARA,2460,3241,5701
77085,MALUKU UTARA,77364,HALMAHERA UTARA,77413,MALIFUT,0,0,0
77085,MALUKU UTARA,77364,HALMAHERA UTARA,77373,TOBELO,4846,7549,12395
77085,MALUKU UTARA,77364,HALMAHERA UTARA,77483,TOBELO BARAT,0,0,0
77085,MALUKU UTARA,77364,HALMAHERA UTARA,77384,TOBELO SELATAN,0,0,0
77085,MALUKU UTARA,77364,HALMAHERA UTARA,77466,TOBELO TENGAH,0,0,0
77085,MALUKU UTARA,77364,HALMAHERA UTARA,77476,TOBELO TIMUR,0,0,0
77085,MALUKU UTARA,77364,HALMAHERA UTARA,77455,TOBELO UTARA,0,0,0
77085,MALUKU UTARA,77858,KEPULAUAN SULA,77952,LEDE,0,0,0
77085,MALUKU UTARA,77858,KEPULAUAN SULA,77890,MANGOLI BARAT,0,0,0
77085,MALUKU UTARA,77858,KEPULAUAN SULA,77920,MANGOLI SELATAN,0,0,0
77085,MALUKU UTARA,77858,KEPULAUAN SULA,77914,MANGOLI TENGAH,0,0,0
77085,MALUKU UTARA,77858,KEPULAUAN SULA,77859,MANGOLI TIMUR,0,0,0
77085,MALUKU UTARA,77858,KEPULAUAN SULA,77925,MANGOLI UTARA,0,0,0
77085,MALUKU UTARA,77858,KEPULAUAN SULA,77910,MANGOLI UTARA TIMUR,0,0,0
77085,MALUKU UTARA,77858,KEPULAUAN SULA,77863,SANANA,0,0,0
77085,MALUKU UTARA,77858,KEPULAUAN SULA,77948,SANANA UTARA,0,0,0
77085,MALUKU UTARA,77858,KEPULAUAN SULA,77875,SULABESI BARAT,0,0,0
77085,MALUKU UTARA,77858,KEPULAUAN SULA,77906,SULABESI SELATAN,0,0,0
77085,MALUKU UTARA,77858,KEPULAUAN SULA,77895,SULABESI TENGAH,0,0,0
77085,MALUKU UTARA,77858,KEPULAUAN SULA,77901,SULABESI TIMUR,0,0,0
77085,MALUKU UTARA,77858,KEPULAUAN SULA,77879,TALIABU BARAT,0,0,0
77085,MALUKU UTARA,77858,KEPULAUAN SULA,77940,TALIABU BARAT LAUT,0,0,0
77085,MALUKU UTARA,77858,KEPULAUAN SULA,77942,TALIABU SELATAN,0,0,0
77085,MALUKU UTARA,77858,KEPULAUAN SULA,77884,TALIABU TIMUR SELATAN,0,0,0
77085,MALUKU UTARA,77858,KEPULAUAN SULA,77932,TALIABU UTARA,0,0,0
77085,MALUKU UTARA,78040,KOTA TERNATE,78059,KOTA TERNATE SELATAN,16263,9880,26143
77085,MALUKU UTARA,78040,KOTA TERNATE,78106,KOTA TERNATE TENGAH,14474,8731,23205
77085,MALUKU UTARA,78040,KOTA TERNATE,78077,KOTA TERNATE UTARA,14462,6523,20985
77085,MALUKU UTARA,78040,KOTA TERNATE,78099,PULAU BATANG DUA,513,856,1369
77085,MALUKU UTARA,78040,KOTA TERNATE,83861,PULAU HIRI,1533,460,1993
77085,MALUKU UTARA,78040,KOTA TERNATE,78092,PULAU MOTI,1435,740,2175
77085,MALUKU UTARA,78040,KOTA TERNATE,78041,PULAU TERNATE,5363,2923,8286
77085,MALUKU UTARA,78122,KOTA TIDORE KEPULAUAN,78148,OBA,3709,2789,6498
77085,MALUKU UTARA,78122,KOTA TIDORE KEPULAUAN,78190,OBA SELATAN,1489,1272,2761
77085,MALUKU UTARA,78122,KOTA TIDORE KEPULAUAN,78180,OBA TENGAH,2248,2017,4265
77085,MALUKU UTARA,78122,KOTA TIDORE KEPULAUAN,78135,OBA UTARA,3989,3526,7515
77085,MALUKU UTARA,78122,KOTA TIDORE KEPULAUAN,78123,TIDORE,4815,4765,9580
77085,MALUKU UTARA,78122,KOTA TIDORE KEPULAUAN,78158,TIDORE SELATAN,4054,3388,7442
77085,MALUKU UTARA,78122,KOTA TIDORE KEPULAUAN,78198,TIDORE TIMUR,2489,1905,4394
77085,MALUKU UTARA,78122,KOTA TIDORE KEPULAUAN,78167,TIDORE UTARA,4878,4178,9056
77085,MALUKU UTARA,77086,PULAU MOROTAI,77126,MOROTAI JAYA,2983,1678,4661
77085,MALUKU UTARA,77086,PULAU MOROTAI,77087,MOROTAI SELATAN,9896,2714,12610
77085,MALUKU UTARA,77086,PULAU MOROTAI,77108,MOROTAI SELATAN BARAT,3507,3268,6775
77085,MALUKU UTARA,77086,PULAU MOROTAI,77146,MOROTAI TIMUR,4136,1800,5936
77085,MALUKU UTARA,77086,PULAU MOROTAI,77136,MOROTAI UTARA,4180,1943,6123
54020,NUSA TENGGARA BARAT,54666,BIMA,54774,AMBALAWI,7547,2223,9770
54020,NUSA TENGGARA BARAT,54666,BIMA,54709,BELO,9428,3198,12626
54020,NUSA TENGGARA BARAT,54666,BIMA,54680,BOLO,18939,6451,25390
54020,NUSA TENGGARA BARAT,54666,BIMA,54758,DONGGO,6796,3926,10722
54020,NUSA TENGGARA BARAT,54666,BIMA,54837,LAMBITU,1899,897,2796
54020,NUSA TENGGARA BARAT,54666,BIMA,54794,LAMBU,9291,7400,16691
54020,NUSA TENGGARA BARAT,54666,BIMA,54781,LANGGUDU,9581,4432,14013
54020,NUSA TENGGARA BARAT,54666,BIMA,54807,MADAPANGGA,11572,4056,15628
54020,NUSA TENGGARA BARAT,54666,BIMA,54667,MONTA,12132,4158,16290
54020,NUSA TENGGARA BARAT,54666,BIMA,54843,PALIBELO,11550,3089,14639
54020,NUSA TENGGARA BARAT,54666,BIMA,54831,PARADO,3459,1210,4669
54020,NUSA TENGGARA BARAT,54666,BIMA,54767,SANGGAR,4389,1890,6279
54020,NUSA TENGGARA BARAT,54666,BIMA,54728,SAPE,18741,8296,27037
54020,NUSA TENGGARA BARAT,54666,BIMA,54824,SOROMANDI,6099,2925,9024
54020,NUSA TENGGARA BARAT,54666,BIMA,54818,TAMBORA,2977,898,3875
54020,NUSA TENGGARA BARAT,54666,BIMA,54718,WAWO,6694,2243,8937
54020,NUSA TENGGARA BARAT,54666,BIMA,54746,WERA,10583,3909,14492
54020,NUSA TENGGARA BARAT,54666,BIMA,54693,WOHA,17163,6135,23298
54020,NUSA TENGGARA BARAT,54590,DOMPU,54591,DOMPU,20307,7573,27880
54020,NUSA TENGGARA BARAT,54590,DOMPU,54606,KEMPO,5876,4334,10210
54020,NUSA TENGGARA BARAT,54590,DOMPU,54621,KILO,4173,2907,7080
54020,NUSA TENGGARA BARAT,54590,DOMPU,54650,MANGGELEWA,10634,4799,15433
54020,NUSA TENGGARA BARAT,54590,DOMPU,54660,PAJO,3946,2613,6559
54020,NUSA TENGGARA BARAT,54590,DOMPU,54641,PEKAT,11348,4409,15757
54020,NUSA TENGGARA BARAT,54590,DOMPU,54628,WOJA,23787,6455,30242
54020,NUSA TENGGARA BARAT,54982,KOTA BIMA,54998,ASAKOTA,11720,3835,15555
54020,NUSA TENGGARA BARAT,54982,KOTA BIMA,55015,MPUNDA,12356,3611,15967
54020,NUSA TENGGARA BARAT,54982,KOTA BIMA,55003,RABA,16782,4233,21015
54020,NUSA TENGGARA BARAT,54982,KOTA BIMA,54983,RASANAE BARAT,11255,5313,16568
54020,NUSA TENGGARA BARAT,54982,KOTA BIMA,54990,RASANAE TIMUR,7781,1924,9705
54020,NUSA TENGGARA BARAT,54925,KOTA MATARAM,54926,AMPENAN,29978,12509,42487
54020,NUSA TENGGARA BARAT,54925,KOTA MATARAM,54947,CAKRANEGARA,17264,17743,35007
54020,NUSA TENGGARA BARAT,54925,KOTA MATARAM,54937,MATARAM,26003,14298,40301
54020,NUSA TENGGARA BARAT,54925,KOTA MATARAM,54974,SANDUBAYA,23620,10409,34029
54020,NUSA TENGGARA BARAT,54925,KOTA MATARAM,54958,SEKARBELA,20223,5899,26122
54020,NUSA TENGGARA BARAT,54925,KOTA MATARAM,54964,SELAPARANG,26653,10789,37442
54020,NUSA TENGGARA BARAT,54021,LOMBOK BARAT,54111,BATU LAYAR,20702,5925,26627
54020,NUSA TENGGARA BARAT,54021,LOMBOK BARAT,54022,GERUNG,35127,8377,43504
54020,NUSA TENGGARA BARAT,54021,LOMBOK BARAT,54080,GUNUNGSARI,36017,10051,46068
54020,NUSA TENGGARA BARAT,54021,LOMBOK BARAT,54034,KEDIRI,25993,4354,30347
54020,NUSA TENGGARA BARAT,54021,LOMBOK BARAT,54118,KURIPAN,14754,3518,18272
54020,NUSA TENGGARA BARAT,54021,LOMBOK BARAT,54069,LABUAPI,29243,6295,35538
54020,NUSA TENGGARA BARAT,54021,LOMBOK BARAT,54105,LEMBAR,17663,6825,24488
54020,NUSA TENGGARA BARAT,54021,LOMBOK BARAT,54094,LINGSAR,28021,10248,38269
54020,NUSA TENGGARA BARAT,54021,LOMBOK BARAT,54045,NARMADA,37474,14159,51633
54020,NUSA TENGGARA BARAT,54021,LOMBOK BARAT,54062,SEKOTONG,19572,9377,28949
54020,NUSA TENGGARA BARAT,54123,LOMBOK TENGAH,54153,BATUKLIANG,29263,12250,41513
54020,NUSA TENGGARA BARAT,54123,LOMBOK TENGAH,54251,BATUKLIANG UTARA,20233,6817,27050
54020,NUSA TENGGARA BARAT,54123,LOMBOK TENGAH,54200,JANAPRIA,32028,8038,40066
54020,NUSA TENGGARA BARAT,54123,LOMBOK TENGAH,54139,JONGGAT,37787,12812,50599
54020,NUSA TENGGARA BARAT,54123,LOMBOK TENGAH,54219,KOPANG,33793,10706,44499
54020,NUSA TENGGARA BARAT,54123,LOMBOK TENGAH,54124,PRAYA,46096,12956,59052
54020,NUSA TENGGARA BARAT,54123,LOMBOK TENGAH,54179,PRAYA BARAT,28144,10197,38341
54020,NUSA TENGGARA BARAT,54123,LOMBOK TENGAH,54240,PRAYA BARAT DAYA,20063,6895,26958
54020,NUSA TENGGARA BARAT,54123,LOMBOK TENGAH,54229,PRAYA TENGAH,26887,7597,34484
54020,NUSA TENGGARA BARAT,54123,LOMBOK TENGAH,54189,PRAYA TIMUR,27544,12019,39563
54020,NUSA TENGGARA BARAT,54123,LOMBOK TENGAH,54211,PRINGGARATA,22808,11330,34138
54020,NUSA TENGGARA BARAT,54123,LOMBOK TENGAH,54163,PUJUT,37982,17423,55405
54020,NUSA TENGGARA BARAT,54260,LOMBOK TIMUR,54322,AIKMEL,35889,16393,52282
54020,NUSA TENGGARA BARAT,54260,LOMBOK TIMUR,54395,JEROWARU,20828,8098,28926
54020,NUSA TENGGARA BARAT,54260,LOMBOK TIMUR,54261,KERUAK,20366,6057,26423
54020,NUSA TENGGARA BARAT,54260,LOMBOK TIMUR,54375,LABUHAN HAJI,24367,6505,30872
54020,NUSA TENGGARA BARAT,54260,LOMBOK TIMUR,54288,MASBAGIK,44466,10279,54745
54020,NUSA TENGGARA BARAT,54260,LOMBOK TIMUR,54338,MONTONG GADING,17521,6041,23562
54020,NUSA TENGGARA BARAT,54260,LOMBOK TIMUR,54314,PRINGGABAYA,36013,13434,49447
54020,NUSA TENGGARA BARAT,54260,LOMBOK TIMUR,54344,PRINGGASELA,22359,6865,29224
54020,NUSA TENGGARA BARAT,54260,LOMBOK TIMUR,54266,SAKRA,23304,6451,29755
54020,NUSA TENGGARA BARAT,54260,LOMBOK TIMUR,54389,SAKRA BARAT,18774,7668,26442
54020,NUSA TENGGARA BARAT,54260,LOMBOK TIMUR,54383,SAKRA TIMUR,15562,6510,22072
54020,NUSA TENGGARA BARAT,54260,LOMBOK TIMUR,54332,SAMBELIA,10475,5775,16250
54020,NUSA TENGGARA BARAT,54260,LOMBOK TIMUR,54302,SELONG,36603,8288,44891
54020,NUSA TENGGARA BARAT,54260,LOMBOK TIMUR,54363,SEMBALUN,7845,3466,11311
54020,NUSA TENGGARA BARAT,54260,LOMBOK TIMUR,54280,SIKUR,29868,9454,39322
54020,NUSA TENGGARA BARAT,54260,LOMBOK TIMUR,54296,SUKAMULIA,13822,3510,17332
54020,NUSA TENGGARA BARAT,54260,LOMBOK TIMUR,54349,SURALAGA,20089,8854,28943
54020,NUSA TENGGARA BARAT,54260,LOMBOK TIMUR,54368,SUWELA,15264,6188,21452
54020,NUSA TENGGARA BARAT,54260,LOMBOK TIMUR,54272,TERARA,28186,8338,36524
54020,NUSA TENGGARA BARAT,54260,LOMBOK TIMUR,54356,WANASABA,29945,7421,37366
54020,NUSA TENGGARA BARAT,55026,LOMBOK UTARA,55050,BAYAN,17154,8682,25836
54020,NUSA TENGGARA BARAT,55026,LOMBOK UTARA,55035,GANGGA,19140,6418,25558
54020,NUSA TENGGARA BARAT,55026,LOMBOK UTARA,55041,KAYANGAN,18048,5380,23428
54020,NUSA TENGGARA BARAT,55026,LOMBOK UTARA,55060,PEMENANG,12621,4471,17092
54020,NUSA TENGGARA BARAT,55026,LOMBOK UTARA,55027,TANJUNG,16376,10895,27271
54020,NUSA TENGGARA BARAT,54400,SUMBAWA,54409,ALAS,9407,5921,15328
54020,NUSA TENGGARA BARAT,54400,SUMBAWA,54502,ALAS BARAT,7630,3679,11309
54020,NUSA TENGGARA BARAT,54400,SUMBAWA,54428,BATU LANTEH,4458,1478,5936
54020,NUSA TENGGARA BARAT,54400,SUMBAWA,54525,BUER,4508,3363,7871
54020,NUSA TENGGARA BARAT,54400,SUMBAWA,54491,EMPANG,7815,5527,13342
54020,NUSA TENGGARA BARAT,54400,SUMBAWA,54519,LABANGKA,3444,1766,5210
54020,NUSA TENGGARA BARAT,54400,SUMBAWA,54511,LABUHAN BADAS,10407,6264,16671
54020,NUSA TENGGARA BARAT,54400,SUMBAWA,54585,LANTUNG,1149,646,1795
54020,NUSA TENGGARA BARAT,54400,SUMBAWA,54474,LAPE,6934,3081,10015
54020,NUSA TENGGARA BARAT,54400,SUMBAWA,54575,LENANGGUAR,2751,1403,4154
54020,NUSA TENGGARA BARAT,54400,SUMBAWA,54567,LOPOK,7142,4039,11181
54020,NUSA TENGGARA BARAT,54400,SUMBAWA,54401,LUNYUK,6484,3889,10373
54020,NUSA TENGGARA BARAT,54400,SUMBAWA,54553,MARONGE,3767,1984,5751
54020,NUSA TENGGARA BARAT,54400,SUMBAWA,54444,MOYO HILIR,10159,3976,14135
54020,NUSA TENGGARA BARAT,54400,SUMBAWA,54455,MOYO HULU,8516,4749,13265
54020,NUSA TENGGARA BARAT,54400,SUMBAWA,54546,MOYO UTARA,4420,1639,6059
54020,NUSA TENGGARA BARAT,54400,SUMBAWA,54580,ORONG TELU,1634,999,2633
54020,NUSA TENGGARA BARAT,54400,SUMBAWA,54479,PLAMPANG,10389,5546,15935
54020,NUSA TENGGARA BARAT,54400,SUMBAWA,54532,RHEE,2033,2082,4115
54020,NUSA TENGGARA BARAT,54400,SUMBAWA,54468,ROPANG,2065,1110,3175
54020,NUSA TENGGARA BARAT,54400,SUMBAWA,54435,SUMBAWA,20983,9951,30934
54020,NUSA TENGGARA BARAT,54400,SUMBAWA,54558,TARANO,4879,3688,8567
54020,NUSA TENGGARA BARAT,54400,SUMBAWA,54537,UNTER IWES,8807,2732,11539
54020,NUSA TENGGARA BARAT,54400,SUMBAWA,54418,UTAN,10274,6027,16301
54020,NUSA TENGGARA BARAT,54853,SUMBAWA BARAT,54912,BRANG ENE,2316,902,3218
54020,NUSA TENGGARA BARAT,54853,SUMBAWA BARAT,54893,BRANG REA,5402,2320,7722
54020,NUSA TENGGARA BARAT,54853,SUMBAWA BARAT,54854,JEREWEH,3518,1366,4884
54020,NUSA TENGGARA BARAT,54853,SUMBAWA BARAT,54919,MALUK,2860,2253,5113
54020,NUSA TENGGARA BARAT,54853,SUMBAWA BARAT,54903,POTO TANO,3410,2295,5705
54020,NUSA TENGGARA BARAT,54853,SUMBAWA BARAT,54885,SEKONGKANG,2490,1626,4116
54020,NUSA TENGGARA BARAT,54853,SUMBAWA BARAT,54874,SETELUK,6027,3421,9448
54020,NUSA TENGGARA BARAT,54853,SUMBAWA BARAT,54859,TALIWANG,17911,8002,25913
55065,NUSA TENGGARA TIMUR,56051,ALOR,56089,ALOR BARAT DAYA,4136,6653,10789
55065,NUSA TENGGARA TIMUR,56051,ALOR,56069,ALOR BARAT LAUT,6511,4020,10531
55065,NUSA TENGGARA TIMUR,56051,ALOR,56110,ALOR SELATAN,1481,3212,4693
55065,NUSA TENGGARA TIMUR,56051,ALOR,56148,ALOR TENGAH UTARA,2169,3456,5625
55065,NUSA TENGGARA TIMUR,56051,ALOR,56125,ALOR TIMUR,1553,2485,4038
55065,NUSA TENGGARA TIMUR,56051,ALOR,56163,ALOR TIMUR LAUT,1107,3082,4189
55065,NUSA TENGGARA TIMUR,56051,ALOR,56180,KABOLA,1675,2521,4196
55065,NUSA TENGGARA TIMUR,56051,ALOR,56218,LEMBUR,709,1626,2335
55065,NUSA TENGGARA TIMUR,56051,ALOR,56193,MATARU,1104,1836,2940
55065,NUSA TENGGARA TIMUR,56051,ALOR,56136,PANTAR,2907,1884,4791
55065,NUSA TENGGARA TIMUR,56051,ALOR,56172,PANTAR BARAT,2300,902,3202
55065,NUSA TENGGARA TIMUR,56051,ALOR,56236,PANTAR BARAT LAUT,1376,905,2281
55065,NUSA TENGGARA TIMUR,56051,ALOR,56225,PANTAR TENGAH,2925,1941,4866
55065,NUSA TENGGARA TIMUR,56051,ALOR,56206,PANTAR TIMUR,2674,2910,5584
55065,NUSA TENGGARA TIMUR,56051,ALOR,56186,PULAU PURA,1027,1732,2759
55065,NUSA TENGGARA TIMUR,56051,ALOR,56201,PUREMAN,328,1257,1585
55065,NUSA TENGGARA TIMUR,56051,ALOR,56052,TELUK MUTIARA,13512,11536,25048
55065,NUSA TENGGARA TIMUR,55819,BELU,56031,ATAMBUA BARAT,4030,4922,8952
55065,NUSA TENGGARA TIMUR,55819,BELU,56036,ATAMBUA SELATAN,5209,4914,10123
55065,NUSA TENGGARA TIMUR,55819,BELU,56025,BOTIN LEO BELE,596,1339,1935
55065,NUSA TENGGARA TIMUR,55819,BELU,56017,IO KUFEU,1104,2115,3219
55065,NUSA TENGGARA TIMUR,55819,BELU,55859,KAKULUK MESAK,5591,2679,8270
55065,NUSA TENGGARA TIMUR,55819,BELU,55873,KOBALIMA,3864,3187,7051
55065,NUSA TENGGARA TIMUR,55819,BELU,56046,KOBALIMA TIMUR,1306,1026,2332
55065,NUSA TENGGARA TIMUR,55819,BELU,55947,KOTA ATAMBUA,7072,4497,11569
55065,NUSA TENGGARA TIMUR,55819,BELU,55962,LAEN MANEN,973,3719,4692
55065,NUSA TENGGARA TIMUR,55819,BELU,55820,LAMAKNEN,3065,1912,4977
55065,NUSA TENGGARA TIMUR,55819,BELU,56008,LAMAKNEN SELATAN,1023,1938,2961
55065,NUSA TENGGARA TIMUR,55819,BELU,56000,LASIOLAT,1041,1826,2867
55065,NUSA TENGGARA TIMUR,55819,BELU,55910,MALAKA BARAT,1851,6446,8297
55065,NUSA TENGGARA TIMUR,55819,BELU,55882,MALAKA TENGAH,5237,9300,14537
55065,NUSA TENGGARA TIMUR,55819,BELU,55866,MALAKA TIMUR,1353,2508,3861
55065,NUSA TENGGARA TIMUR,55819,BELU,56041,NANAET DUABESI,601,1016,1617
55065,NUSA TENGGARA TIMUR,55819,BELU,55843,RAIHAT,3932,1684,5616
55065,NUSA TENGGARA TIMUR,55819,BELU,55952,RAIMANUK,2527,3086,5613
55065,NUSA TENGGARA TIMUR,55819,BELU,55927,RINHAT,2106,3369,5475
55065,NUSA TENGGARA TIMUR,55819,BELU,55900,SASITAMEAN,838,2660,3498
55065,NUSA TENGGARA TIMUR,55819,BELU,55850,TASIFETO BARAT,4421,4315,8736
55065,NUSA TENGGARA TIMUR,55819,BELU,55830,TASIFETOTIMUR,5595,3965,9560
55065,NUSA TENGGARA TIMUR,55819,BELU,55985,WELIMAN,1599,5422,7021
55065,NUSA TENGGARA TIMUR,55819,BELU,55972,WEWIKU,1634,5143,6777
55065,NUSA TENGGARA TIMUR,56671,ENDE,56857,DETUKELI,435,2541,2976
55065,NUSA TENGGARA TIMUR,56671,ENDE,56739,DETUSOKO,513,6460,6973
55065,NUSA TENGGARA TIMUR,56671,ENDE,56699,ENDE,908,7647,8555
55065,NUSA TENGGARA TIMUR,56671,ENDE,56718,ENDE SELATAN,7877,4510,12387
55065,NUSA TENGGARA TIMUR,56671,ENDE,56892,ENDE TENGAH,3316,9188,12504
55065,NUSA TENGGARA TIMUR,56671,ENDE,56897,ENDE TIMUR,2832,7081,9913
55065,NUSA TENGGARA TIMUR,56671,ENDE,56884,ENDE UTARA,4259,4501,8760
55065,NUSA TENGGARA TIMUR,56671,ENDE,56848,KELIMUTU,350,3033,3383
55065,NUSA TENGGARA TIMUR,56671,ENDE,56835,KOTA BARU,513,4048,4561
55065,NUSA TENGGARA TIMUR,56671,ENDE,83887,LEPEMBUSU KELISOKE,341,2231,2572
55065,NUSA TENGGARA TIMUR,56671,ENDE,56826,LIO TIMUR,574,2774,3348
55065,NUSA TENGGARA TIMUR,56671,ENDE,56815,MAUKARO,452,2953,3405
55065,NUSA TENGGARA TIMUR,56671,ENDE,56805,MAUROLE,961,3990,4951
55065,NUSA TENGGARA TIMUR,56671,ENDE,56672,NANGAPANDA,3396,7971,11367
55065,NUSA TENGGARA TIMUR,56671,ENDE,56724,NDONA,1621,5545,7166
55065,NUSA TENGGARA TIMUR,56671,ENDE,56871,NDONA TIMUR,296,2008,2304
55065,NUSA TENGGARA TIMUR,56671,ENDE,56878,NDORI,1415,1152,2567
55065,NUSA TENGGARA TIMUR,56671,ENDE,56691,PULAU ENDE,3213,1027,4240
55065,NUSA TENGGARA TIMUR,56671,ENDE,56764,WEWARIA,1373,7010,8383
55065,NUSA TENGGARA TIMUR,56671,ENDE,56798,WOLOJITA,496,2731,3227
55065,NUSA TENGGARA TIMUR,56671,ENDE,56782,WOLOWARU,2838,5010,7848
55065,NUSA TENGGARA TIMUR,56244,FLORES TIMUR,56468,ADONARA,1702,2929,4631
55065,NUSA TENGGARA TIMUR,56244,FLORES TIMUR,56349,ADONARA BARAT,1233,4314,5547
55065,NUSA TENGGARA TIMUR,56244,FLORES TIMUR,56476,ADONARA TENGAH,1076,3948,5024
55065,NUSA TENGGARA TIMUR,56244,FLORES TIMUR,56379,ADONARA TIMUR,4819,6765,11584
55065,NUSA TENGGARA TIMUR,56244,FLORES TIMUR,56447,DEMON PAGONG,234,2222,2456
55065,NUSA TENGGARA TIMUR,56244,FLORES TIMUR,56426,ILE BOLENG,1364,5491,6855
55065,NUSA TENGGARA TIMUR,56244,FLORES TIMUR,56462,ILE BURA,373,2842,3215
55065,NUSA TENGGARA TIMUR,56244,FLORES TIMUR,56286,ILE MANDIRI,681,4161,4842
55065,NUSA TENGGARA TIMUR,56244,FLORES TIMUR,56399,KELUBAGOLIT,1121,4650,5771
55065,NUSA TENGGARA TIMUR,56244,FLORES TIMUR,56269,LARANTUKA,4811,12877,17688
55065,NUSA TENGGARA TIMUR,56244,FLORES TIMUR,56454,LEWOLEMA,728,3337,4065
55065,NUSA TENGGARA TIMUR,56244,FLORES TIMUR,56310,SOLOR BARAT,679,3673,4352
55065,NUSA TENGGARA TIMUR,56244,FLORES TIMUR,83886,SOLOR SELATAN,268,2039,2307
55065,NUSA TENGGARA TIMUR,56244,FLORES TIMUR,56329,SOLOR TIMUR,3524,2406,5930
55065,NUSA TENGGARA TIMUR,56244,FLORES TIMUR,56295,TANJUNG BUNGA,911,4830,5741
55065,NUSA TENGGARA TIMUR,56244,FLORES TIMUR,56256,TITEHENA,1035,4651,5686
55065,NUSA TENGGARA TIMUR,56244,FLORES TIMUR,56412,WITIHAMA,985,6830,7815
55065,NUSA TENGGARA TIMUR,56244,FLORES TIMUR,56366,WOTAN ULUMANDO,802,2792,3594
55065,NUSA TENGGARA TIMUR,56244,FLORES TIMUR,56245,WULANGGITANG,771,5693,6464
55065,NUSA TENGGARA TIMUR,58040,KOTA KUPANG,58041,ALAK,13433,16174,29607
55065,NUSA TENGGARA TIMUR,58040,KOTA KUPANG,58064,KELAPA LIMA,11236,19350,30586
55065,NUSA TENGGARA TIMUR,58040,KOTA KUPANG,58087,KOTA LAMA,6555,9020,15575
55065,NUSA TENGGARA TIMUR,58040,KOTA KUPANG,58079,KOTA RAJA,10007,15302,25309
55065,NUSA TENGGARA TIMUR,58040,KOTA KUPANG,58054,MAULAFA,16342,20772,37114
55065,NUSA TENGGARA TIMUR,58040,KOTA KUPANG,58070,OEBOBO,14788,26656,41444
55065,NUSA TENGGARA TIMUR,55066,KUPANG,55309,AMABI OEFETO,2073,1575,3648
55065,NUSA TENGGARA TIMUR,55066,KUPANG,55270,AMABI OEFETO TIMUR,3626,2481,6107
55065,NUSA TENGGARA TIMUR,55066,KUPANG,55160,AMARASI,4200,3663,7863
55065,NUSA TENGGARA TIMUR,55066,KUPANG,55250,AMARASI BARAT,3976,3329,7305
55065,NUSA TENGGARA TIMUR,55066,KUPANG,55259,AMARASI SELATAN,2260,2596,4856
55065,NUSA TENGGARA TIMUR,55066,KUPANG,55265,AMARASI TIMUR,1774,1661,3435
55065,NUSA TENGGARA TIMUR,55066,KUPANG,55281,AMFOANG BARAT DAYA,1261,899,2160
55065,NUSA TENGGARA TIMUR,55066,KUPANG,55286,AMFOANG BARAT LAUT,1653,2381,4034
55065,NUSA TENGGARA TIMUR,55066,KUPANG,55197,AMFOANG SELATAN,2334,1722,4056
55065,NUSA TENGGARA TIMUR,55066,KUPANG,55338,AMFOANG TENGAH,2039,662,2701
55065,NUSA TENGGARA TIMUR,55066,KUPANG,55317,AMFOANG TIMUR,1885,1252,3137
55065,NUSA TENGGARA TIMUR,55066,KUPANG,55209,AMFOANG UTARA,1614,1521,3135
55065,NUSA TENGGARA TIMUR,55066,KUPANG,55170,FATULEU,5439,5342,10781
55065,NUSA TENGGARA TIMUR,55066,KUPANG,55323,FATULEU BARAT,2798,1227,4025
55065,NUSA TENGGARA TIMUR,55066,KUPANG,55329,FATULEU TENGAH,1816,604,2420
55065,NUSA TENGGARA TIMUR,55066,KUPANG,55107,KUPANG BARAT,4276,4098,8374
55065,NUSA TENGGARA TIMUR,55066,KUPANG,55146,KUPANG TENGAH,7440,10073,17513
55065,NUSA TENGGARA TIMUR,55066,KUPANG,55120,KUPANG TIMUR,10288,9635,19923
55065,NUSA TENGGARA TIMUR,55066,KUPANG,55237,NEKAMESE,3006,2001,5007
55065,NUSA TENGGARA TIMUR,55066,KUPANG,55094,SEMAU,1138,1993,3131
55065,NUSA TENGGARA TIMUR,55066,KUPANG,55293,SEMAU SELATAN,1056,1148,2204
55065,NUSA TENGGARA TIMUR,55066,KUPANG,55138,SULAMU,3016,4088,7104
55065,NUSA TENGGARA TIMUR,55066,KUPANG,55300,TAEBENU,4328,3603,7931
55065,NUSA TENGGARA TIMUR,55066,KUPANG,55186,TAKARI,5807,4042,9849
55065,NUSA TENGGARA TIMUR,57406,LEMBATA,57422,ATADEI,640,3258,3898
55065,NUSA TENGGARA TIMUR,57406,LEMBATA,57513,BUYASURI,0,0,0
55065,NUSA TENGGARA TIMUR,57406,LEMBATA,57438,ILE APE,0,0,0
55065,NUSA TENGGARA TIMUR,57406,LEMBATA,57550,ILE APE TIMUR,0,0,0
55065,NUSA TENGGARA TIMUR,57406,LEMBATA,57455,LEBATUKAN,0,0,0
55065,NUSA TENGGARA TIMUR,57406,LEMBATA,57407,NAGA WUTUNG,0,0,0
55065,NUSA TENGGARA TIMUR,57406,LEMBATA,57473,NUBATUKAN,3699,11779,15478
55065,NUSA TENGGARA TIMUR,57406,LEMBATA,57491,OMESURI,3001,3863,6864
55065,NUSA TENGGARA TIMUR,57406,LEMBATA,57534,WULANDONI,1063,3301,4364
55065,NUSA TENGGARA TIMUR,57008,MANGGARAI,57063,CIBAL,2833,8776,11609
55065,NUSA TENGGARA TIMUR,57008,MANGGARAI,83545,CIBAL BARAT,1469,4460,5929
55065,NUSA TENGGARA TIMUR,57008,MANGGARAI,57112,LANGKE REMBONG,8209,21318,29527
55065,NUSA TENGGARA TIMUR,57008,MANGGARAI,57158,LELAK,970,3989,4959
55065,NUSA TENGGARA TIMUR,57008,MANGGARAI,57145,RAHONG UTARA,2247,6514,8761
55065,NUSA TENGGARA TIMUR,57008,MANGGARAI,57091,REOK,3439,5436,8875
55065,NUSA TENGGARA TIMUR,57008,MANGGARAI,83544,REOK BARAT,1764,4548,6312
55065,NUSA TENGGARA TIMUR,57008,MANGGARAI,57026,RUTENG,3454,13886,17340
55065,NUSA TENGGARA TIMUR,57008,MANGGARAI,57043,SATAR MESE,3392,9395,12787
55065,NUSA TENGGARA TIMUR,57008,MANGGARAI,57124,SATAR MESE BARAT,3566,9561,13127
55065,NUSA TENGGARA TIMUR,57008,MANGGARAI,57009,WAE RII,2685,9469,12154
55065,NUSA TENGGARA TIMUR,57649,MANGGARAI BARAT,57756,BOLENG,3227,6077,9304
55065,NUSA TENGGARA TIMUR,57649,MANGGARAI BARAT,57739,KOMODO,8090,11996,20086
55065,NUSA TENGGARA TIMUR,57649,MANGGARAI BARAT,57664,KUWUS,2813,9559,12372
55065,NUSA TENGGARA TIMUR,57649,MANGGARAI BARAT,57692,LEMBOR,4283,10726,15009
55065,NUSA TENGGARA TIMUR,57649,MANGGARAI BARAT,83549,LEMBOR SELATAN,3628,6945,10573
55065,NUSA TENGGARA TIMUR,57649,MANGGARAI BARAT,57650,MACANG PACAR,1776,11692,13468
55065,NUSA TENGGARA TIMUR,57649,MANGGARAI BARAT,83550,MBELILING,1637,4411,6048
55065,NUSA TENGGARA TIMUR,57649,MANGGARAI BARAT,83548,NDOSO,1826,8086,9912
55065,NUSA TENGGARA TIMUR,57649,MANGGARAI BARAT,57714,SANO NGGOANG,1781,4270,6051
55065,NUSA TENGGARA TIMUR,57649,MANGGARAI BARAT,57766,WELAK,2019,8054,10073
55065,NUSA TENGGARA TIMUR,58098,MANGGARAI TIMUR,58099,BORONG,4729,12064,16793
55065,NUSA TENGGARA TIMUR,58098,MANGGARAI TIMUR,58179,ELAR,2014,3885,5899
55065,NUSA TENGGARA TIMUR,58098,MANGGARAI TIMUR,83556,ELAR SELATAN,1245,6037,7282
55065,NUSA TENGGARA TIMUR,58098,MANGGARAI TIMUR,58201,KOTA KOMBA,5188,15459,20647
55065,NUSA TENGGARA TIMUR,58098,MANGGARAI TIMUR,58150,LAMBA LEDA,3947,9445,13392
55065,NUSA TENGGARA TIMUR,58098,MANGGARAI TIMUR,58121,POCO RANAKA,3666,10401,14067
55065,NUSA TENGGARA TIMUR,58098,MANGGARAI TIMUR,83555,POCO RANAKA TIMUR,2188,8381,10569
55065,NUSA TENGGARA TIMUR,58098,MANGGARAI TIMUR,83554,RANA MESE,1917,9762,11679
55065,NUSA TENGGARA TIMUR,58098,MANGGARAI TIMUR,58167,SAMBI RAMPAS,4812,6799,11611
55065,NUSA TENGGARA TIMUR,57778,NAGEKEO,57779,AESESA,3131,13398,16529
55065,NUSA TENGGARA TIMUR,57778,NAGEKEO,57880,AESESA SELATAN,295,2382,2677
55065,NUSA TENGGARA TIMUR,57778,NAGEKEO,57814,BOAWAE,1647,14469,16116
55065,NUSA TENGGARA TIMUR,57778,NAGEKEO,57865,KEO TENGAH,667,6481,7148
55065,NUSA TENGGARA TIMUR,57778,NAGEKEO,57838,MAUPONGGO,1479,9386,10865
55065,NUSA TENGGARA TIMUR,57778,NAGEKEO,57798,NANGARORO,1049,8201,9250
55065,NUSA TENGGARA TIMUR,57778,NAGEKEO,57859,WOLOWAE,360,2109,2469
55065,NUSA TENGGARA TIMUR,56904,NGADA,56905,AIMERE,1232,2877,4109
55065,NUSA TENGGARA TIMUR,56904,NGADA,56940,BAJAWA,4962,11058,16020
55065,NUSA TENGGARA TIMUR,56904,NGADA,56995,BAJAWA UTARA,1091,2697,3788
55065,NUSA TENGGARA TIMUR,56904,NGADA,56918,GOLEWA,1544,6114,7658
55065,NUSA TENGGARA TIMUR,56904,NGADA,83542,GOLEWA BARAT,1568,2604,4172
55065,NUSA TENGGARA TIMUR,56904,NGADA,83541,GOLEWA SELATAN,1381,3449,4830
55065,NUSA TENGGARA TIMUR,56904,NGADA,83543,INERIE,796,2509,3305
55065,NUSA TENGGARA TIMUR,56904,NGADA,56979,JEREBUU,663,2482,3145
55065,NUSA TENGGARA TIMUR,56904,NGADA,56966,RIUNG,2459,4068,6527
55065,NUSA TENGGARA TIMUR,56904,NGADA,56988,RIUNG BARAT,1466,2087,3553
55065,NUSA TENGGARA TIMUR,56904,NGADA,56958,SOA,2551,3622,6173
55065,NUSA TENGGARA TIMUR,56904,NGADA,57003,WOLOMEZE,630,1993,2623
55065,NUSA TENGGARA TIMUR,57560,ROTE NDAO,83547,LANDU LEKO,712,1378,2090
55065,NUSA TENGGARA TIMUR,57560,ROTE NDAO,57588,LOBALAIN,2279,10009,12288
55065,NUSA TENGGARA TIMUR,57560,ROTE NDAO,83546,NDAO NUSE,161,1328,1489
55065,NUSA TENGGARA TIMUR,57560,ROTE NDAO,57611,PANTAI BARU,1092,4933,6025
55065,NUSA TENGGARA TIMUR,57560,ROTE NDAO,57643,ROTE  SELATAN,658,1780,2438
55065,NUSA TENGGARA TIMUR,57560,ROTE NDAO,57634,ROTE BARAT,804,2572,3376
55065,NUSA TENGGARA TIMUR,57560,ROTE NDAO,57561,ROTE BARAT DAYA,1371,7588,8959
55065,NUSA TENGGARA TIMUR,57560,ROTE NDAO,57575,ROTE BARAT LAUT,2016,7978,9994
55065,NUSA TENGGARA TIMUR,57560,ROTE NDAO,57603,ROTE TENGAH,1226,2459,3685
55065,NUSA TENGGARA TIMUR,57560,ROTE NDAO,57623,ROTE TIMUR,1543,4457,6000
55065,NUSA TENGGARA TIMUR,58219,SABU RAIJUA,58270,HAWU MEHARA,2063,5124,7187
55065,NUSA TENGGARA TIMUR,58219,SABU RAIJUA,58279,RAIJUA,545,3232,3777
55065,NUSA TENGGARA TIMUR,58219,SABU RAIJUA,58220,SABU BARAT,4931,8473,13404
55065,NUSA TENGGARA TIMUR,58219,SABU RAIJUA,58261,SABU LIAE,1230,3070,4300
55065,NUSA TENGGARA TIMUR,58219,SABU RAIJUA,58237,SABU TENGAH,1307,2034,3341
55065,NUSA TENGGARA TIMUR,58219,SABU RAIJUA,58245,SABU TIMUR,1087,2664,3751
55065,NUSA TENGGARA TIMUR,56489,SIKKA,56533,ALOK,3735,10479,14214
55065,NUSA TENGGARA TIMUR,56489,SIKKA,56608,ALOK BARAT,2459,5280,7739
55065,NUSA TENGGARA TIMUR,56489,SIKKA,56613,ALOK TIMUR,5088,9300,14388
55065,NUSA TENGGARA TIMUR,56489,SIKKA,56588,BOLA,1092,4041,5133
55065,NUSA TENGGARA TIMUR,56489,SIKKA,56658,DORENG,871,3749,4620
55065,NUSA TENGGARA TIMUR,56489,SIKKA,56640,HEWOKLOANG,615,3370,3985
55065,NUSA TENGGARA TIMUR,56489,SIKKA,56648,KANGAE,2104,6064,8168
55065,NUSA TENGGARA TIMUR,56489,SIKKA,56579,KEWAPANTE,1406,4729,6135
55065,NUSA TENGGARA TIMUR,56489,SIKKA,56624,KOTING,621,2932,3553
55065,NUSA TENGGARA TIMUR,56489,SIKKA,56510,LELA,661,5257,5918
55065,NUSA TENGGARA TIMUR,56489,SIKKA,56595,MAGEPANDA,867,4492,5359
55065,NUSA TENGGARA TIMUR,56489,SIKKA,56666,MAPITARA,322,2712,3034
55065,NUSA TENGGARA TIMUR,56489,SIKKA,56499,MEGO,937,4528,5465
55065,NUSA TENGGARA TIMUR,56489,SIKKA,56550,NELLE,507,2643,3150
55065,NUSA TENGGARA TIMUR,56489,SIKKA,56520,NITA,1177,9850,11027
55065,NUSA TENGGARA TIMUR,56489,SIKKA,56490,PAGA,1139,6066,7205
55065,NUSA TENGGARA TIMUR,56489,SIKKA,56541,PALUE,479,3490,3969
55065,NUSA TENGGARA TIMUR,56489,SIKKA,56556,TALIBURA,2845,6288,9133
55065,NUSA TENGGARA TIMUR,56489,SIKKA,56631,TANA WAWO,966,3236,4202
55065,NUSA TENGGARA TIMUR,56489,SIKKA,56601,WAIBLAMA,859,2495,3354
55065,NUSA TENGGARA TIMUR,56489,SIKKA,56569,WAIGETE,1627,7910,9537
55065,NUSA TENGGARA TIMUR,57346,SUMBA BARAT,57389,KOTA WAIKABUBAK,4389,7931,12320
55065,NUSA TENGGARA TIMUR,57346,SUMBA BARAT,57401,LABOYA BARAT,897,2089,2986
55065,NUSA TENGGARA TIMUR,57346,SUMBA BARAT,57379,LAMBOYA,1860,4630,6490
55065,NUSA TENGGARA TIMUR,57346,SUMBA BARAT,57359,LOLI,3456,7113,10569
55065,NUSA TENGGARA TIMUR,57346,SUMBA BARAT,57347,TANA RIGHU,1253,5860,7113
55065,NUSA TENGGARA TIMUR,57346,SUMBA BARAT,57368,WANOKAKA,1736,4501,6237
55065,NUSA TENGGARA TIMUR,57935,SUMBA BARAT DAYA,58015,KODI,2417,16285,18702
55065,NUSA TENGGARA TIMUR,57935,SUMBA BARAT DAYA,83553,KODI BALAGHAR,2177,3791,5968
55065,NUSA TENGGARA TIMUR,57935,SUMBA BARAT DAYA,58001,KODI BANGEDO,2692,10449,13141
55065,NUSA TENGGARA TIMUR,57935,SUMBA BARAT DAYA,58027,KODI UTARA,2744,21582,24326
55065,NUSA TENGGARA TIMUR,57935,SUMBA BARAT DAYA,83551,KOTA TAMBOLAKA,3045,9933,12978
55065,NUSA TENGGARA TIMUR,57935,SUMBA BARAT DAYA,57936,LOURA,1191,5726,6917
55065,NUSA TENGGARA TIMUR,57935,SUMBA BARAT DAYA,57977,WEWEWA BARAT,10160,16705,26865
55065,NUSA TENGGARA TIMUR,57935,SUMBA BARAT DAYA,57992,WEWEWA SELATAN,5303,5936,11239
55065,NUSA TENGGARA TIMUR,57935,SUMBA BARAT DAYA,83552,WEWEWA TENGAH,10088,13276,23364
55065,NUSA TENGGARA TIMUR,57935,SUMBA BARAT DAYA,57956,WEWEWA TIMUR,6599,9111,15710
55065,NUSA TENGGARA TIMUR,57935,SUMBA BARAT DAYA,57949,WEWEWA UTARA,4180,6384,10564
55065,NUSA TENGGARA TIMUR,57886,SUMBA TENGAH,57887,KATIKU TANA,1080,3573,4653
55065,NUSA TENGGARA TIMUR,57886,SUMBA TENGAH,57927,KATIKU TANA SELATAN,0,0,0
55065,NUSA TENGGARA TIMUR,57886,SUMBA TENGAH,57905,MAMBORO,0,0,0
55065,NUSA TENGGARA TIMUR,57886,SUMBA TENGAH,57915,UMBU RATU NGGAY,0,0,0
55065,NUSA TENGGARA TIMUR,57886,SUMBA TENGAH,57893,UMBU RATU NGGAY BARAT,0,0,0
55065,NUSA TENGGARA TIMUR,57167,SUMBA TIMUR,57176,HAHARU,644,1715,2359
55065,NUSA TENGGARA TIMUR,57167,SUMBA TIMUR,57281,KAHAUNGU ETI,1074,2576,3650
55065,NUSA TENGGARA TIMUR,57167,SUMBA TIMUR,57307,KAMBATA MAPAMBUHANG,466,1242,1708
55065,NUSA TENGGARA TIMUR,57167,SUMBA TIMUR,57298,KAMBERA,3417,11945,15362
55065,NUSA TENGGARA TIMUR,57167,SUMBA TIMUR,57327,KANATANG,898,3001,3899
55065,NUSA TENGGARA TIMUR,57167,SUMBA TIMUR,57273,KARERA,976,2485,3461
55065,NUSA TENGGARA TIMUR,57167,SUMBA TIMUR,57321,KATALA HAMU LINGU,380,1309,1689
55065,NUSA TENGGARA TIMUR,57167,SUMBA TIMUR,57168,KOTA WAINGAPU,5444,9825,15269
55065,NUSA TENGGARA TIMUR,57167,SUMBA TIMUR,57184,LEWA,1620,4827,6447
55065,NUSA TENGGARA TIMUR,57167,SUMBA TIMUR,57314,LEWA TIDAHU,648,2139,2787
55065,NUSA TENGGARA TIMUR,57167,SUMBA TIMUR,57339,MAHU,788,1000,1788
55065,NUSA TENGGARA TIMUR,57167,SUMBA TIMUR,57291,MATAWAI LA PAWU,589,1798,2387
55065,NUSA TENGGARA TIMUR,57167,SUMBA TIMUR,57333,NGADU NGALA,429,1797,2226
55065,NUSA TENGGARA TIMUR,57167,SUMBA TIMUR,57193,NGGAHA ORI ANGU,1124,2702,3826
55065,NUSA TENGGARA TIMUR,57167,SUMBA TIMUR,57265,PABERIWAI,475,1671,2146
55065,NUSA TENGGARA TIMUR,57167,SUMBA TIMUR,57248,PAHUNGA LODU,1938,3692,5630
55065,NUSA TENGGARA TIMUR,57167,SUMBA TIMUR,57220,PANDAWAI,1730,5574,7304
55065,NUSA TENGGARA TIMUR,57167,SUMBA TIMUR,57213,PINU PAHAR,869,2494,3363
55065,NUSA TENGGARA TIMUR,57167,SUMBA TIMUR,57239,RINDI,1428,2756,4184
55065,NUSA TENGGARA TIMUR,57167,SUMBA TIMUR,57202,TABUNDUNG,1195,2919,4114
55065,NUSA TENGGARA TIMUR,57167,SUMBA TIMUR,57228,UMALULU,2605,4977,7582
55065,NUSA TENGGARA TIMUR,57167,SUMBA TIMUR,57257,WULLA WAIJELU,1078,2458,3536
55065,NUSA TENGGARA TIMUR,55347,TIMOR TENGAH SELATAN,55426,AMANATUN SELATAN,0,0,0
55065,NUSA TENGGARA TIMUR,55347,TIMOR TENGAH SELATAN,55440,AMANATUN UTARA,0,0,0
55065,NUSA TENGGARA TIMUR,55347,TIMOR TENGAH SELATAN,55418,AMANUBAN BARAT,0,0,0
55065,NUSA TENGGARA TIMUR,55347,TIMOR TENGAH SELATAN,55407,AMANUBAN SELATAN,0,0,0
55065,NUSA TENGGARA TIMUR,55347,TIMOR TENGAH SELATAN,55395,AMANUBAN TENGAH,0,0,0
55065,NUSA TENGGARA TIMUR,55347,TIMOR TENGAH SELATAN,55384,AMANUBAN TIMUR,0,0,0
55065,NUSA TENGGARA TIMUR,55347,TIMOR TENGAH SELATAN,55485,BATU PUTIH,0,0,0
55065,NUSA TENGGARA TIMUR,55347,TIMOR TENGAH SELATAN,55493,BOKING,0,0,0
55065,NUSA TENGGARA TIMUR,55347,TIMOR TENGAH SELATAN,55598,FATUKOPA,0,0,0
55065,NUSA TENGGARA TIMUR,55347,TIMOR TENGAH SELATAN,55469,FATUMNASI,0,0,0
55065,NUSA TENGGARA TIMUR,55347,TIMOR TENGAH SELATAN,55593,FAUTMOLO,0,0,0
55065,NUSA TENGGARA TIMUR,55347,TIMOR TENGAH SELATAN,55561,KOK BAUN,0,0,0
55065,NUSA TENGGARA TIMUR,55347,TIMOR TENGAH SELATAN,55526,KOLBANO,0,0,0
55065,NUSA TENGGARA TIMUR,55347,TIMOR TENGAH SELATAN,55538,KOT OLIN,0,0,0
55065,NUSA TENGGARA TIMUR,55347,TIMOR TENGAH SELATAN,55348,KOTA SOE,0,0,0
55065,NUSA TENGGARA TIMUR,55347,TIMOR TENGAH SELATAN,55547,KUALIN,0,0,0
55065,NUSA TENGGARA TIMUR,55347,TIMOR TENGAH SELATAN,55461,KUANFATU,0,0,0
55065,NUSA TENGGARA TIMUR,55347,TIMOR TENGAH SELATAN,55585,KUATNANA,0,0,0
55065,NUSA TENGGARA TIMUR,55347,TIMOR TENGAH SELATAN,55555,MOLLO BARAT,0,0,0
55065,NUSA TENGGARA TIMUR,55347,TIMOR TENGAH SELATAN,55362,MOLLO SELATAN,0,0,0
55065,NUSA TENGGARA TIMUR,55347,TIMOR TENGAH SELATAN,55603,MOLLO TENGAH,0,0,0
55065,NUSA TENGGARA TIMUR,55347,TIMOR TENGAH SELATAN,55370,MOLLO UTARA,0,0,0
55065,NUSA TENGGARA TIMUR,55347,TIMOR TENGAH SELATAN,55568,NOEBANA,0,0,0
55065,NUSA TENGGARA TIMUR,55347,TIMOR TENGAH SELATAN,55578,NOEBEBA,0,0,0
55065,NUSA TENGGARA TIMUR,55347,TIMOR TENGAH SELATAN,55615,NUNBENA,0,0,0
55065,NUSA TENGGARA TIMUR,55347,TIMOR TENGAH SELATAN,55508,NUNKOLO,0,0,0
55065,NUSA TENGGARA TIMUR,55347,TIMOR TENGAH SELATAN,55518,OENINO,0,0,0
55065,NUSA TENGGARA TIMUR,55347,TIMOR TENGAH SELATAN,55474,POLEN,0,0,0
55065,NUSA TENGGARA TIMUR,55347,TIMOR TENGAH SELATAN,55573,SANTIAN,0,0,0
55065,NUSA TENGGARA TIMUR,55347,TIMOR TENGAH SELATAN,55610,TOBU,0,0,0
55065,NUSA TENGGARA TIMUR,55347,TIMOR TENGAH SELATAN,55500,TOIANAS,0,0,0
55065,NUSA TENGGARA TIMUR,55620,TIMOR TENGAH UTARA,55686,BIBOKI ANLEU,2905,3429,6334
55065,NUSA TENGGARA TIMUR,55620,TIMOR TENGAH UTARA,55813,BIBOKI FEOTLEU,898,845,1743
55065,NUSA TENGGARA TIMUR,55620,TIMOR TENGAH UTARA,55805,BIBOKI MOENLEU,1426,1498,2924
55065,NUSA TENGGARA TIMUR,55620,TIMOR TENGAH UTARA,55646,BIBOKI SELATAN,1721,1771,3492
55065,NUSA TENGGARA TIMUR,55620,TIMOR TENGAH UTARA,55800,BIBOKI TAN PAH,1260,1046,2306
55065,NUSA TENGGARA TIMUR,55620,TIMOR TENGAH UTARA,55678,BIBOKI UTARA,2434,1994,4428
55065,NUSA TENGGARA TIMUR,55620,TIMOR TENGAH UTARA,55757,BIKOMI NILULAT,1017,1171,2188
55065,NUSA TENGGARA TIMUR,55620,TIMOR TENGAH UTARA,55739,BIKOMI SELATAN,2097,2374,4471
55065,NUSA TENGGARA TIMUR,55620,TIMOR TENGAH UTARA,55748,BIKOMI TENGAH,1562,1725,3287
55065,NUSA TENGGARA TIMUR,55620,TIMOR TENGAH UTARA,55764,BIKOMI UTARA,1278,1729,3007
55065,NUSA TENGGARA TIMUR,55620,TIMOR TENGAH UTARA,55696,INSANA,2973,5449,8422
55065,NUSA TENGGARA TIMUR,55620,TIMOR TENGAH UTARA,55786,INSANA BARAT,1605,2440,4045
55065,NUSA TENGGARA TIMUR,55620,TIMOR TENGAH UTARA,55779,INSANA FAFINESU,575,1887,2462
55065,NUSA TENGGARA TIMUR,55620,TIMOR TENGAH UTARA,55794,INSANA TENGAH,1743,2938,4681
55065,NUSA TENGGARA TIMUR,55620,TIMOR TENGAH UTARA,55710,INSANA UTARA,1351,2748,4099
55065,NUSA TENGGARA TIMUR,55620,TIMOR TENGAH UTARA,55668,KOTA KEFAMENANU,9860,10179,20039
55065,NUSA TENGGARA TIMUR,55620,TIMOR TENGAH UTARA,55721,MIOMAFFO TENGAH,1224,1519,2743
55065,NUSA TENGGARA TIMUR,55620,TIMOR TENGAH UTARA,55633,MIOMAFO BARAT,2102,4818,6920
55065,NUSA TENGGARA TIMUR,55620,TIMOR TENGAH UTARA,55621,MIOMAFO TIMUR,2365,3118,5483
55065,NUSA TENGGARA TIMUR,55620,TIMOR TENGAH UTARA,55727,MUSI,515,1645,2160
55065,NUSA TENGGARA TIMUR,55620,TIMOR TENGAH UTARA,55734,MUTIS,1030,1877,2907
55065,NUSA TENGGARA TIMUR,55620,TIMOR TENGAH UTARA,55774,NAIBENU,1233,1173,2406
55065,NUSA TENGGARA TIMUR,55620,TIMOR TENGAH UTARA,55655,NOEMUTI,1248,4561,5809
55065,NUSA TENGGARA TIMUR,55620,TIMOR TENGAH UTARA,55716,NOEMUTI TIMUR,534,1456,1990
78203,PAPUA,79163,ASMAT,79164,AGATS,0,0,0
78203,PAPUA,79163,ASMAT,79234,AKAT,0,0,0
78203,PAPUA,79163,ASMAT,79174,ATSJ,0,0,0
78203,PAPUA,79163,ASMAT,83713,AYIP,0,0,0
78203,PAPUA,79163,ASMAT,83714,BETCBAMU,0,0,0
78203,PAPUA,79163,ASMAT,83709,DER KOUMUR,0,0,0
78203,PAPUA,79163,ASMAT,79244,FAYIT,0,0,0
78203,PAPUA,79163,ASMAT,84099,JETSY,0,0,0
78203,PAPUA,79163,ASMAT,83706,JOERAT,0,0,0
78203,PAPUA,79163,ASMAT,83717,KOLF BRAZA,0,0,0
78203,PAPUA,79163,ASMAT,83710,KOPAY,0,0,0
78203,PAPUA,79163,ASMAT,79257,PANTAI KASUARI,0,0,0
78203,PAPUA,79163,ASMAT,83707,PULAU TIGA,0,0,0
78203,PAPUA,79163,ASMAT,83711,SAFAN,0,0,0
78203,PAPUA,79163,ASMAT,79197,SAWA ERMA,0,0,0
78203,PAPUA,79163,ASMAT,83712,SIRETS,0,0,0
78203,PAPUA,79163,ASMAT,79293,SUATOR,0,0,0
78203,PAPUA,79163,ASMAT,83719,UNIR SIRAU,0,0,0
78203,PAPUA,80526,BIAK NUMFOR,83624,AIMANDO PADAIDO,121,1123,1244
78203,PAPUA,80526,BIAK NUMFOR,83619,ANDEY,117,1091,1208
78203,PAPUA,80526,BIAK NUMFOR,80628,BIAK BARAT,219,2481,2700
78203,PAPUA,80526,BIAK NUMFOR,80527,BIAK KOTA,3216,12715,15931
78203,PAPUA,80526,BIAK NUMFOR,80562,BIAK TIMUR,256,3336,3592
78203,PAPUA,80526,BIAK NUMFOR,80543,BIAK UTARA,490,2938,3428
78203,PAPUA,80526,BIAK NUMFOR,83862,BONDIFUAR,22,315,337
78203,PAPUA,80526,BIAK NUMFOR,83621,BRUYADORI,65,710,775
78203,PAPUA,80526,BIAK NUMFOR,80593,NUMFOR BARAT,85,914,999
78203,PAPUA,80526,BIAK NUMFOR,80612,NUMFOR TIMUR,124,776,900
78203,PAPUA,80526,BIAK NUMFOR,83625,ORIDEK,138,2304,2442
78203,PAPUA,80526,BIAK NUMFOR,83622,ORKERI,91,671,762
78203,PAPUA,80526,BIAK NUMFOR,80678,PADAIDO,156,882,1038
78203,PAPUA,80526,BIAK NUMFOR,83623,POIRU,54,850,904
78203,PAPUA,80526,BIAK NUMFOR,80713,SAMOFA,3126,7954,11080
78203,PAPUA,80526,BIAK NUMFOR,83620,SWANDIWE,364,1898,2262
78203,PAPUA,80526,BIAK NUMFOR,80657,WARSA,192,2143,2335
78203,PAPUA,80526,BIAK NUMFOR,83618,YAWOSI,67,974,1041
78203,PAPUA,80526,BIAK NUMFOR,80698,YENDIDORI,397,3296,3693
78203,PAPUA,78927,BOVEN DIGOEL,83682,AMBATKWI,56,434,490
78203,PAPUA,78927,BOVEN DIGOEL,83679,ARIMOP,86,1035,1121
78203,PAPUA,78927,BOVEN DIGOEL,79009,BOMAKIA,387,895,1282
78203,PAPUA,78927,BOVEN DIGOEL,83685,FIRIWAGE,36,599,635
78203,PAPUA,78927,BOVEN DIGOEL,83680,FOFI,95,1157,1252
78203,PAPUA,78927,BOVEN DIGOEL,83678,INIYANDIT,100,284,384
78203,PAPUA,78927,BOVEN DIGOEL,78998,JAIR,3760,7009,10769
78203,PAPUA,78927,BOVEN DIGOEL,83694,KAWAGIT,63,493,556
78203,PAPUA,78927,BOVEN DIGOEL,83692,KI,47,527,574
78203,PAPUA,78927,BOVEN DIGOEL,83688,KOMBAY,45,830,875
78203,PAPUA,78927,BOVEN DIGOEL,83677,KOMBUT,22,435,457
78203,PAPUA,78927,BOVEN DIGOEL,78979,KOUH,62,382,444
78203,PAPUA,78927,BOVEN DIGOEL,78928,MANDOBO,1209,3928,5137
78203,PAPUA,78927,BOVEN DIGOEL,83684,MANGGELUM,93,431,524
78203,PAPUA,78927,BOVEN DIGOEL,78942,MINDIPTANA,192,1455,1647
78203,PAPUA,78927,BOVEN DIGOEL,83690,NINATI,2,291,293
78203,PAPUA,78927,BOVEN DIGOEL,83691,SESNUK,55,142,197
78203,PAPUA,78927,BOVEN DIGOEL,83687,SUBUR,39,842,881
78203,PAPUA,78927,BOVEN DIGOEL,78964,WAROPKO,141,649,790
78203,PAPUA,78927,BOVEN DIGOEL,83686,YANIRUMA,527,504,1031
78203,PAPUA,78289,DEIYAI,78305,BOWOBADO,77,4400,4477
78203,PAPUA,78289,DEIYAI,78322,KAPIRAYA,712,2000,2712
78203,PAPUA,78289,DEIYAI,78290,TIGI,0,0,0
78203,PAPUA,78289,DEIYAI,78309,TIGI BARAT,0,0,0
78203,PAPUA,78289,DEIYAI,78298,TIGI TIMUR,579,8942,9521
78203,PAPUA,79752,DOGIYAI,83759,DOGIYAI,0,0,0
78203,PAPUA,79752,DOGIYAI,79753,KAMU,0,0,0
78203,PAPUA,79752,DOGIYAI,79803,KAMU SELATAN,0,0,0
78203,PAPUA,79752,DOGIYAI,79811,KAMU TIMUR,0,0,0
78203,PAPUA,79752,DOGIYAI,79777,KAMU UTARA,0,0,0
78203,PAPUA,79752,DOGIYAI,83754,MAPIA,0,0,0
78203,PAPUA,79752,DOGIYAI,83756,MAPIA BARAT,0,0,0
78203,PAPUA,79752,DOGIYAI,79819,MAPIA TENGAH,0,0,0
78203,PAPUA,79752,DOGIYAI,83755,PIYAIYE,0,0,0
78203,PAPUA,79752,DOGIYAI,79782,SUKIKAI SELATAN,0,0,0
78203,PAPUA,78204,INTAN JAYA,78267,AGISIGA,0,0,0
78203,PAPUA,78204,INTAN JAYA,78251,BIANDOGA,0,0,0
78203,PAPUA,78204,INTAN JAYA,78280,HITADIPA,0,0,0
78203,PAPUA,78204,INTAN JAYA,78222,HOMEYO,0,0,0
78203,PAPUA,78204,INTAN JAYA,78205,SUGAPA,0,0,0
78203,PAPUA,78204,INTAN JAYA,78241,WANDAI,0,0,0
78203,PAPUA,80144,JAYAPURA,80283,AIRU,216,861,1077
78203,PAPUA,80144,JAYAPURA,80236,DEMTA,308,1488,1796
78203,PAPUA,80144,JAYAPURA,80164,DEPAPRE,489,1968,2457
78203,PAPUA,80144,JAYAPURA,80249,EBUNGFA,320,1383,1703
78203,PAPUA,80144,JAYAPURA,80298,GRESI  SELATAN,25,676,701
78203,PAPUA,80144,JAYAPURA,80244,KAUREH,2068,4892,6960
78203,PAPUA,80144,JAYAPURA,80179,KEMTUK,472,2063,2535
78203,PAPUA,80144,JAYAPURA,80191,KEMTUK GRESI,301,2260,2561
78203,PAPUA,80144,JAYAPURA,80263,NAMBLUONG,952,1142,2094
78203,PAPUA,80144,JAYAPURA,80219,NIMBOKRANG,2555,1419,3974
78203,PAPUA,80144,JAYAPURA,80204,NIMBORAN,470,2553,3023
78203,PAPUA,80144,JAYAPURA,80293,RAVENI RARA,134,1652,1786
78203,PAPUA,80144,JAYAPURA,80145,SENTANI,18424,24796,43220
78203,PAPUA,80144,JAYAPURA,80173,SENTANI BARAT,637,1431,2068
78203,PAPUA,80144,JAYAPURA,80156,SENTANI TIMUR,950,3343,4293
78203,PAPUA,80144,JAYAPURA,80229,UNURUM GUAY,250,1137,1387
78203,PAPUA,80144,JAYAPURA,80255,WAIBU,2437,5828,8265
78203,PAPUA,80144,JAYAPURA,80273,YAPSI,1907,1188,3095
78203,PAPUA,80144,JAYAPURA,80303,YOKARI,161,1260,1421
78203,PAPUA,80015,JAYAWIJAYA,80031,ASOLOGAIMA,0,0,0
78203,PAPUA,80015,JAYAWIJAYA,80075,ASOLOKOBAL,0,0,0
78203,PAPUA,80015,JAYAWIJAYA,83611,ASOTIPO,0,0,0
78203,PAPUA,80015,JAYAWIJAYA,83609,BIPIRI,0,0,0
78203,PAPUA,80015,JAYAWIJAYA,80113,BOLAKME,0,0,0
78203,PAPUA,80015,JAYAWIJAYA,83608,BUGI,0,0,0
78203,PAPUA,80015,JAYAWIJAYA,83591,HUBIKIAK,0,0,0
78203,PAPUA,80015,JAYAWIJAYA,80094,HUBIKOSI,0,0,0
78203,PAPUA,80015,JAYAWIJAYA,83592,IBELE,0,0,0
78203,PAPUA,80015,JAYAWIJAYA,83594,ITLAY HISAGE,0,0,0
78203,PAPUA,80015,JAYAWIJAYA,83601,KORAGI,0,0,0
78203,PAPUA,80015,JAYAWIJAYA,80052,KURULU,0,0,0
78203,PAPUA,80015,JAYAWIJAYA,83598,LIBAREK,0,0,0
78203,PAPUA,80015,JAYAWIJAYA,83612,MAIMA,0,0,0
78203,PAPUA,80015,JAYAWIJAYA,83603,MOLAGALOME,0,0,0
78203,PAPUA,80015,JAYAWIJAYA,83607,MULIAMA,0,0,0
78203,PAPUA,80015,JAYAWIJAYA,80070,MUSATFAK,0,0,0
78203,PAPUA,80015,JAYAWIJAYA,83588,NAPUA,0,0,0
78203,PAPUA,80015,JAYAWIJAYA,80100,PELEBAGA,0,0,0
78203,PAPUA,80015,JAYAWIJAYA,83606,PIRAMID,0,0,0
78203,PAPUA,80015,JAYAWIJAYA,83600,PISUGI,0,0,0
78203,PAPUA,80015,JAYAWIJAYA,84093,POPUGOBA,0,0,0
78203,PAPUA,80015,JAYAWIJAYA,83595,SIEPKOSI,0,0,0
78203,PAPUA,80015,JAYAWIJAYA,83605,SILO KARNO DOGA,0,0,0
78203,PAPUA,80015,JAYAWIJAYA,83593,TAELAREK,0,0,0
78203,PAPUA,80015,JAYAWIJAYA,83602,TAGIME,0,0,0
78203,PAPUA,80015,JAYAWIJAYA,83604,TAGINERI,0,0,0
78203,PAPUA,80015,JAYAWIJAYA,83587,TRIKORA,0,0,0
78203,PAPUA,80015,JAYAWIJAYA,83596,USILIMO,0,0,0
78203,PAPUA,80015,JAYAWIJAYA,83599,WADANGKU,0,0,0
78203,PAPUA,80015,JAYAWIJAYA,83589,WALAIK,0,0,0
78203,PAPUA,80015,JAYAWIJAYA,80085,WALELAGAMA,0,0,0
78203,PAPUA,80015,JAYAWIJAYA,83585,WAME,0,0,0
78203,PAPUA,80015,JAYAWIJAYA,80016,WAMENA,0,0,0
78203,PAPUA,80015,JAYAWIJAYA,83610,WELESI,0,0,0
78203,PAPUA,80015,JAYAWIJAYA,83586,WESAPUT,0,0,0
78203,PAPUA,80015,JAYAWIJAYA,84091,WITA WAYA,0,0,0
78203,PAPUA,80015,JAYAWIJAYA,80135,WOLO,0,0,0
78203,PAPUA,80015,JAYAWIJAYA,83590,WOUMA,0,0,0
78203,PAPUA,80015,JAYAWIJAYA,80129,YALENGGA,0,0,0
78203,PAPUA,81192,KEEROM,81200,ARSO,0,0,0
78203,PAPUA,81192,KEEROM,81241,ARSO TIMUR,0,0,0
78203,PAPUA,81192,KEEROM,81218,SENGGI,0,0,0
78203,PAPUA,81192,KEEROM,81232,SKANTO,0,0,0
78203,PAPUA,81192,KEEROM,81253,TOWE,0,0,0
78203,PAPUA,81192,KEEROM,81193,WARIS,0,0,0
78203,PAPUA,81192,KEEROM,81225,WEB,0,0,0
78203,PAPUA,80402,KEPULAUAN YAPEN,80437,ANGKAISERA,0,0,0
78203,PAPUA,80402,KEPULAUAN YAPEN,80499,KEPULAUAN AMBAI,0,0,0
78203,PAPUA,80402,KEPULAUAN YAPEN,80459,KOSIWO,0,0,0
78203,PAPUA,80402,KEPULAUAN YAPEN,80452,POOM,0,0,0
78203,PAPUA,80402,KEPULAUAN YAPEN,83616,PULAU KURUDU,0,0,0
78203,PAPUA,80402,KEPULAUAN YAPEN,83617,PULAU YERUI,0,0,0
78203,PAPUA,80402,KEPULAUAN YAPEN,80477,RAIMBAWI,0,0,0
78203,PAPUA,80402,KEPULAUAN YAPEN,80489,TELUK AMPIMOI,0,0,0
78203,PAPUA,80402,KEPULAUAN YAPEN,80517,WINDESI,0,0,0
78203,PAPUA,80402,KEPULAUAN YAPEN,80510,WONAWA,0,0,0
78203,PAPUA,80402,KEPULAUAN YAPEN,80418,YAPEN BARAT,0,0,0
78203,PAPUA,80402,KEPULAUAN YAPEN,80403,YAPEN SELATAN,0,0,0
78203,PAPUA,80402,KEPULAUAN YAPEN,80427,YAPEN TIMUR,0,0,0
78203,PAPUA,80402,KEPULAUAN YAPEN,80470,YAPEN UTARA,0,0,0
78203,PAPUA,79421,KOTA JAYAPURA,79439,ABEPURA,0,0,0
78203,PAPUA,79421,KOTA JAYAPURA,79460,HERAM,0,0,0
78203,PAPUA,79421,KOTA JAYAPURA,79431,JAYAPURA SELATAN,0,0,0
78203,PAPUA,79421,KOTA JAYAPURA,79422,JAYAPURA UTARA,0,0,0
78203,PAPUA,79421,KOTA JAYAPURA,79451,MUARA TAMI,0,0,0
78203,PAPUA,79564,LANNY JAYA,83726,BALINGGA,8854,7056,15910
78203,PAPUA,79564,LANNY JAYA,83724,DIMBA,10001,2216,12217
78203,PAPUA,79564,LANNY JAYA,83723,GAMELIA,8228,8200,16428
78203,PAPUA,79564,LANNY JAYA,83728,KUYAWAGE,10217,440,10657
78203,PAPUA,79564,LANNY JAYA,83722,MAKKI,6435,9551,15986
78203,PAPUA,79564,LANNY JAYA,83725,MELAGINERI,13199,0,13199
78203,PAPUA,79564,LANNY JAYA,83721,PIRIME,190,20065,20255
78203,PAPUA,79564,LANNY JAYA,83863,POGA,6453,4117,10570
78203,PAPUA,79564,LANNY JAYA,83720,TIOM,8756,10964,19720
78203,PAPUA,79564,LANNY JAYA,83727,TIOMNERI,10508,0,10508
78203,PAPUA,79354,MAMBERAMO RAYA,79408,BENUKI,0,0,0
78203,PAPUA,79354,MAMBERAMO RAYA,79391,MAMBERAMO HILIR,0,0,0
78203,PAPUA,79354,MAMBERAMO RAYA,79367,MAMBERAMO HULU,0,0,0
78203,PAPUA,79354,MAMBERAMO RAYA,79355,MAMBERAMO TENGAH,0,0,0
78203,PAPUA,79354,MAMBERAMO RAYA,79383,MAMBERAMO TENGAH TIMUR,0,0,0
78203,PAPUA,79354,MAMBERAMO RAYA,79376,RUFAER,0,0,0
78203,PAPUA,79354,MAMBERAMO RAYA,79415,SAWAI,0,0,0
78203,PAPUA,79354,MAMBERAMO RAYA,79399,WAROPEN ATAS,0,0,0
78203,PAPUA,79466,MAMBERAMO TENGAH,79503,ERAGAYAM,0,0,0
78203,PAPUA,79466,MAMBERAMO TENGAH,79524,ILUGWA,0,0,0
78203,PAPUA,79466,MAMBERAMO TENGAH,79483,KELILA,0,0,0
78203,PAPUA,79466,MAMBERAMO TENGAH,79467,KOBAGMA,0,0,0
78203,PAPUA,79466,MAMBERAMO TENGAH,79519,MEGAMBILIS,0,0,0
78203,PAPUA,79019,MAPPI,79103,ASSUE,571,3626,4197
78203,PAPUA,79019,MAPPI,83700,BAMGI,102,1048,1150
78203,PAPUA,79019,MAPPI,79065,EDERA,658,2032,2690
78203,PAPUA,79019,MAPPI,79084,HAJU,423,4907,5330
78203,PAPUA,79019,MAPPI,79119,KAIBAR,242,768,1010
78203,PAPUA,79019,MAPPI,79141,MINYAMUR,942,1653,2595
78203,PAPUA,79019,MAPPI,79038,NAMBIOMAN BAPAI,397,2588,2985
78203,PAPUA,79019,MAPPI,79020,OBAA,2159,9062,11221
78203,PAPUA,79019,MAPPI,79131,PASSUE,235,2238,2473
78203,PAPUA,79019,MAPPI,83702,PASSUE BAWAH,823,903,1726
78203,PAPUA,79019,MAPPI,83698,SYAHCAME,133,1244,1377
78203,PAPUA,79019,MAPPI,83704,TI  ZAIN,688,2195,2883
78203,PAPUA,79019,MAPPI,79152,VENAHA,157,1032,1189
78203,PAPUA,79019,MAPPI,83699,YAKOMI,160,776,936
78203,PAPUA,79826,MERAUKE,80009,ANIMHA,0,0,0
78203,PAPUA,79826,MERAUKE,79930,ELIKOBAL,0,0,0
78203,PAPUA,79826,MERAUKE,79996,ILWAYAB,0,0,0
78203,PAPUA,79826,MERAUKE,79897,JAGEBOB,0,0,0
78203,PAPUA,79826,MERAUKE,79959,KAPTEL,0,0,0
78203,PAPUA,79826,MERAUKE,79860,KIMAAM,0,0,0
78203,PAPUA,79826,MERAUKE,79943,KURIK,0,0,0
78203,PAPUA,79826,MERAUKE,80001,MALIND,0,0,0
78203,PAPUA,79826,MERAUKE,79827,MERAUKE,0,0,0
78203,PAPUA,79826,MERAUKE,79838,MUTING,0,0,0
78203,PAPUA,79826,MERAUKE,79953,NAUKENJERAI,0,0,0
78203,PAPUA,79826,MERAUKE,79971,NGGUTI,0,0,0
78203,PAPUA,79826,MERAUKE,79851,OKABA,0,0,0
78203,PAPUA,79826,MERAUKE,79872,SEMANGGA,0,0,0
78203,PAPUA,79826,MERAUKE,79912,SOTA,0,0,0
78203,PAPUA,79826,MERAUKE,79977,TABONJI,0,0,0
78203,PAPUA,79826,MERAUKE,79883,TANAH MIRING,0,0,0
78203,PAPUA,79826,MERAUKE,79964,TUBANG,0,0,0
78203,PAPUA,79826,MERAUKE,79918,ULILIN,0,0,0
78203,PAPUA,79826,MERAUKE,79987,WAAN,0,0,0
78203,PAPUA,81007,MIMIKA,81020,AGIMUGA,13,643,656
78203,PAPUA,81007,MIMIKA,81051,JILA,228,2521,2749
78203,PAPUA,81007,MIMIKA,81045,JITA,36,514,550
78203,PAPUA,81007,MIMIKA,81072,KUALA KENCANA,6171,10309,16480
78203,PAPUA,81007,MIMIKA,81034,MIMIKA BARAT,368,1417,1785
78203,PAPUA,81007,MIMIKA,81089,MIMIKA BARAT JAUH,179,1022,1201
78203,PAPUA,81007,MIMIKA,81095,MIMIKA BARAT TENGAH,0,0,0
78203,PAPUA,81007,MIMIKA,81008,MIMIKA BARU,0,0,0
78203,PAPUA,81007,MIMIKA,81025,MIMIKA TIMUR,1136,2628,3764
78203,PAPUA,81007,MIMIKA,81060,MIMIKA TIMUR JAUH,561,2664,3225
78203,PAPUA,81007,MIMIKA,81066,MIMIKA TIMUR TENGAH,643,1283,1926
78203,PAPUA,81007,MIMIKA,81080,TEMBAGAPURA,3940,15873,19813
78203,PAPUA,80309,NABIRE,83614,DIPA,0,0,0
78203,PAPUA,80309,NABIRE,80367,MAKIMI,0,0,0
78203,PAPUA,80309,NABIRE,83615,MENOU,0,0,0
78203,PAPUA,80309,NABIRE,83613,MOORA,0,0,0
78203,PAPUA,80309,NABIRE,80310,NABIRE,0,0,0
78203,PAPUA,80309,NABIRE,80396,NABIRE BARAT,0,0,0
78203,PAPUA,80309,NABIRE,80323,NAPAN,0,0,0
78203,PAPUA,80309,NABIRE,80360,SIRIWO,0,0,0
78203,PAPUA,80309,NABIRE,80379,TELUK KIMI,0,0,0
78203,PAPUA,80309,NABIRE,80374,TELUK UMAR,0,0,0
78203,PAPUA,80309,NABIRE,80337,UWAPA,0,0,0
78203,PAPUA,80309,NABIRE,80354,WANGGAR,0,0,0
78203,PAPUA,80309,NABIRE,80392,WAPOGA,0,0,0
78203,PAPUA,80309,NABIRE,80385,YARO,0,0,0
78203,PAPUA,80309,NABIRE,80332,YAUR,0,0,0
78203,PAPUA,79629,NDUGA,83736,ALAMA,0,0,0
78203,PAPUA,79629,NDUGA,83739,DAL,0,0,0
78203,PAPUA,79629,NDUGA,83745,EMBETPEN,0,0,0
78203,PAPUA,79629,NDUGA,79661,GEAREK,0,0,0
78203,PAPUA,79629,NDUGA,79656,GESELMA,0,0,0
78203,PAPUA,79629,NDUGA,83741,INIKGAL,0,0,0
78203,PAPUA,79629,NDUGA,83742,INIYE,0,0,0
78203,PAPUA,79629,NDUGA,83731,KEGAYEM,0,0,0
78203,PAPUA,79629,NDUGA,79630,KENYAM,0,0,0
78203,PAPUA,79629,NDUGA,83735,KILMID,0,0,0
78203,PAPUA,79629,NDUGA,83746,KORA,0,0,0
78203,PAPUA,79629,NDUGA,83730,KOROPTAK,0,0,0
78203,PAPUA,79629,NDUGA,83753,KREPKURI,0,0,0
78203,PAPUA,79629,NDUGA,83738,MAM,0,0,0
78203,PAPUA,79629,NDUGA,79632,MAPENDUMA,0,0,0
78203,PAPUA,79629,NDUGA,83744,MBUA TENGAH,0,0,0
78203,PAPUA,79629,NDUGA,83743,MBULMU YALMA,0,0,0
78203,PAPUA,79629,NDUGA,79651,MBUWA,0,0,0
78203,PAPUA,79629,NDUGA,83733,MEBAROK,0,0,0
78203,PAPUA,79629,NDUGA,83749,MOBA,0,0,0
78203,PAPUA,79629,NDUGA,79647,MUGI,0,0,0
78203,PAPUA,79629,NDUGA,83751,NENGGEAGIN,0,0,0
78203,PAPUA,79629,NDUGA,83740,NIRKURI,0,0,0
78203,PAPUA,79629,NDUGA,83732,PARO,0,0,0
78203,PAPUA,79629,NDUGA,83752,PASIR PUTIH,0,0,0
78203,PAPUA,79629,NDUGA,83748,PIJA,0,0,0
78203,PAPUA,79629,NDUGA,79642,WOSAK,0,0,0
78203,PAPUA,79629,NDUGA,83747,WUSI,0,0,0
78203,PAPUA,79629,NDUGA,83750,WUTPAGA,0,0,0
78203,PAPUA,79629,NDUGA,83737,YAL,0,0,0
78203,PAPUA,79629,NDUGA,83734,YENGGELO,0,0,0
78203,PAPUA,79629,NDUGA,79637,YIGI,0,0,0
78203,PAPUA,80851,PANIAI,80946,AGISIGA,0,0,0
78203,PAPUA,80851,PANIAI,80892,ARADIDE,0,0,0
78203,PAPUA,80851,PANIAI,80931,BIANDOGA,0,0,0
78203,PAPUA,80851,PANIAI,80938,BIBIDA,0,0,0
78203,PAPUA,80851,PANIAI,80924,BOGABAIDA,0,0,0
78203,PAPUA,80851,PANIAI,80960,BOWOBADO,0,0,0
78203,PAPUA,80851,PANIAI,80953,DUMADAMA,0,0,0
78203,PAPUA,80851,PANIAI,81001,EKADIDE,0,0,0
78203,PAPUA,80851,PANIAI,80966,HITADIPA,0,0,0
78203,PAPUA,80851,PANIAI,80913,HOMEO,0,0,0
78203,PAPUA,80851,PANIAI,80964,KAPIRAYA,0,0,0
78203,PAPUA,80851,PANIAI,80984,KEBO,0,0,0
78203,PAPUA,80851,PANIAI,80871,PANIAI BARAT,0,0,0
78203,PAPUA,80851,PANIAI,80852,PANIAI TIMUR,0,0,0
78203,PAPUA,80851,PANIAI,80956,SIRIWO,0,0,0
78203,PAPUA,80851,PANIAI,80901,SUGAPA,0,0,0
78203,PAPUA,80851,PANIAI,80884,TIGI,0,0,0
78203,PAPUA,80851,PANIAI,80972,TIGI BARAT,0,0,0
78203,PAPUA,80851,PANIAI,80941,TIGI TIMUR,0,0,0
78203,PAPUA,80851,PANIAI,80970,WANDAI,0,0,0
78203,PAPUA,80851,PANIAI,80996,YATAMO,0,0,0
78203,PAPUA,81261,PEGUNUNGAN BINTANG,83649,ABOY,285,1658,1943
78203,PAPUA,81261,PEGUNUNGAN BINTANG,83652,ALEMSOM,0,3021,3021
78203,PAPUA,81261,PEGUNUNGAN BINTANG,83659,AWINBON,0,1526,1526
78203,PAPUA,81261,PEGUNUNGAN BINTANG,83667,BATANI,0,3639,3639
78203,PAPUA,81261,PEGUNUNGAN BINTANG,81332,BATOM,545,2064,2609
78203,PAPUA,81261,PEGUNUNGAN BINTANG,83651,BIME,1000,4866,5866
78203,PAPUA,81261,PEGUNUNGAN BINTANG,81342,BORME,24,5319,5343
78203,PAPUA,81261,PEGUNUNGAN BINTANG,83674,EIPUMEK,504,4866,5370
78203,PAPUA,81261,PEGUNUNGAN BINTANG,81318,IWUR,320,3000,3320
78203,PAPUA,81261,PEGUNUNGAN BINTANG,83671,JETFA,0,2431,2431
78203,PAPUA,81261,PEGUNUNGAN BINTANG,83654,KALOMDOL,61,1450,1511
78203,PAPUA,81261,PEGUNUNGAN BINTANG,83658,KAWOR,0,2662,2662
78203,PAPUA,81261,PEGUNUNGAN BINTANG,81279,KIWIROK,120,2124,2244
78203,PAPUA,81261,PEGUNUNGAN BINTANG,83648,KIWIROK TIMUR,127,2010,2137
78203,PAPUA,81261,PEGUNUNGAN BINTANG,83670,MOFINOP,15,1158,1173
78203,PAPUA,81261,PEGUNUNGAN BINTANG,83669,MURKIM,0,1015,1015
78203,PAPUA,81261,PEGUNUNGAN BINTANG,83676,NONGME,307,2500,2807
78203,PAPUA,81261,PEGUNUNGAN BINTANG,83657,OK AOM,0,1223,1223
78203,PAPUA,81261,PEGUNUNGAN BINTANG,83666,OKBAB,1152,3146,4298
78203,PAPUA,81261,PEGUNUNGAN BINTANG,83653,OKBAPE,10,1325,1335
78203,PAPUA,81261,PEGUNUNGAN BINTANG,83664,OKBEMTAU,0,2791,2791
78203,PAPUA,81261,PEGUNUNGAN BINTANG,81302,OKBIBAB,28,2124,2152
78203,PAPUA,81261,PEGUNUNGAN BINTANG,83661,OKHIKA,62,1340,1402
78203,PAPUA,81261,PEGUNUNGAN BINTANG,83663,OKLIP,0,1386,1386
78203,PAPUA,81261,PEGUNUNGAN BINTANG,83662,OKSAMOL,192,1866,2058
78203,PAPUA,81261,PEGUNUNGAN BINTANG,83665,OKSEBANG,0,1799,1799
78203,PAPUA,81261,PEGUNUNGAN BINTANG,81262,OKSIBIL,295,4759,5054
78203,PAPUA,81261,PEGUNUNGAN BINTANG,83655,OKSOP,337,2675,3012
78203,PAPUA,81261,PEGUNUNGAN BINTANG,83675,PAMEK,66,2900,2966
78203,PAPUA,81261,PEGUNUNGAN BINTANG,83650,PEPERA,44,1480,1524
78203,PAPUA,81261,PEGUNUNGAN BINTANG,83656,SERAMBAKON,11,2227,2238
78203,PAPUA,81261,PEGUNUNGAN BINTANG,83660,TARUP,0,1663,1663
78203,PAPUA,81261,PEGUNUNGAN BINTANG,83673,TEIRAPLU,0,1934,1934
78203,PAPUA,81261,PEGUNUNGAN BINTANG,83668,WEIME,0,4199,4199
78203,PAPUA,79663,PUNCAK,79735,AGANDUGUME,0,11408,11408
78203,PAPUA,79663,PUNCAK,79692,BEOGA,0,25832,25832
78203,PAPUA,79663,PUNCAK,79705,DOUFO,0,6108,6108
78203,PAPUA,79663,PUNCAK,79739,GOME,4476,15397,19873
78203,PAPUA,79663,PUNCAK,79664,ILAGA,3564,27306,30870
78203,PAPUA,79663,PUNCAK,79711,POGOMA,31,14963,14994
78203,PAPUA,79663,PUNCAK,79722,SINAK,0,28061,28061
78203,PAPUA,79663,PUNCAK,79680,WANGBE,0,20021,20021
78203,PAPUA,80724,PUNCAK JAYA,80839,FAWI,1971,3239,5210
78203,PAPUA,80724,PUNCAK JAYA,80781,ILU,0,0,0
78203,PAPUA,80724,PUNCAK JAYA,83635,JIGONIKME,0,0,0
78203,PAPUA,80724,PUNCAK JAYA,83632,MEWOLUK,905,12044,12949
78203,PAPUA,80724,PUNCAK JAYA,80725,MULIA,0,0,0
78203,PAPUA,80724,PUNCAK JAYA,83637,TINGGINAMBUT,2120,26686,28806
78203,PAPUA,80724,PUNCAK JAYA,83636,TORERE,3000,3807,6807
78203,PAPUA,80724,PUNCAK JAYA,83633,YAMO,0,0,0
78203,PAPUA,81104,SARMI,81152,APAWER HULU,0,0,0
78203,PAPUA,81104,SARMI,81141,BONGGO,0,0,0
78203,PAPUA,81104,SARMI,81185,BONGGO TIMUR,0,0,0
78203,PAPUA,81104,SARMI,81122,PANTAI BARAT,0,0,0
78203,PAPUA,81104,SARMI,81134,PANTAI TIMUR,0,0,0
78203,PAPUA,81104,SARMI,81174,PANTAI TIMUR BAGIAN BARAT,0,0,0
78203,PAPUA,81104,SARMI,81105,SARMI,0,0,0
78203,PAPUA,81104,SARMI,81161,SARMI SELATAN,0,0,0
78203,PAPUA,81104,SARMI,81167,SARMI TIMUR,0,0,0
78203,PAPUA,81104,SARMI,81113,TOR ATAS,0,0,0
78203,PAPUA,79310,SUPIORI,79336,KEPULAUAN ARURI,0,0,0
78203,PAPUA,79310,SUPIORI,79346,SUPIORI BARAT,0,0,0
78203,PAPUA,79310,SUPIORI,79311,SUPIORI SELATAN,0,0,0
78203,PAPUA,79310,SUPIORI,79325,SUPIORI TIMUR,0,0,0
78203,PAPUA,79310,SUPIORI,79319,SUPIORI UTARA,0,0,0
78203,PAPUA,78324,TOLIKARA,78821,AIRGARAM,0,0,0
78203,PAPUA,78324,TOLIKARA,83877,ANAWI,0,0,0
78203,PAPUA,78324,TOLIKARA,83900,AWEKU,0,0,0
78203,PAPUA,78324,TOLIKARA,78606,BEWANI,0,0,0
78203,PAPUA,78324,TOLIKARA,83903,BIUK,0,0,0
78203,PAPUA,78324,TOLIKARA,83901,BOGONUK,0,0,0
78203,PAPUA,78324,TOLIKARA,78352,BOKONDINI,0,0,0
78203,PAPUA,78324,TOLIKARA,78588,BOKONERI,0,0,0
78203,PAPUA,78324,TOLIKARA,83897,DANIME,0,0,0
78203,PAPUA,78324,TOLIKARA,78850,DOW,0,0,0
78203,PAPUA,78324,TOLIKARA,78740,DUNDU,0,0,0
78203,PAPUA,78324,TOLIKARA,78776,EGIAM,0,0,0
78203,PAPUA,78324,TOLIKARA,78755,GEYA,0,0,0
78203,PAPUA,78324,TOLIKARA,83875,GIKA,0,0,0
78203,PAPUA,78324,TOLIKARA,78647,GILUBANDU,0,0,0
78203,PAPUA,78324,TOLIKARA,78404,GOYAGE,0,0,0
78203,PAPUA,78324,TOLIKARA,78688,GUNDAGI,0,0,0
78203,PAPUA,78324,TOLIKARA,83899,KAI,0,0,0
78203,PAPUA,78324,TOLIKARA,78808,KAMBONERI,0,0,0
78203,PAPUA,78324,TOLIKARA,78367,KANGGIME,0,0,0
78203,PAPUA,78324,TOLIKARA,78325,KARUBAGA,0,0,0
78203,PAPUA,78324,TOLIKARA,78386,KEMBU,0,0,0
78203,PAPUA,78324,TOLIKARA,78569,KUARI,0,0,0
78203,PAPUA,78324,TOLIKARA,78501,KUBU,0,0,0
78203,PAPUA,78324,TOLIKARA,83902,LI ANOGOMMA,0,0,0
78203,PAPUA,78324,TOLIKARA,78621,NABUNAGE,0,0,0
78203,PAPUA,78324,TOLIKARA,78546,NELAWI,0,0,0
78203,PAPUA,78324,TOLIKARA,78707,NUMBA,0,0,0
78203,PAPUA,78324,TOLIKARA,78661,NUNGGAWI,0,0,0
78203,PAPUA,78324,TOLIKARA,78466,PANAGA,0,0,0
78203,PAPUA,78324,TOLIKARA,78788,POGANERI,0,0,0
78203,PAPUA,78324,TOLIKARA,83898,TAGIME,0,0,0
78203,PAPUA,78324,TOLIKARA,83872,TAGINERI,0,0,0
78203,PAPUA,78324,TOLIKARA,83876,TELENGGEME,0,0,0
78203,PAPUA,78324,TOLIKARA,78725,TIMORI,0,0,0
78203,PAPUA,78324,TOLIKARA,78453,UMAGI,0,0,0
78203,PAPUA,78324,TOLIKARA,83874,WAKUWO,0,0,0
78203,PAPUA,78324,TOLIKARA,83895,WENAM,0,0,0
78203,PAPUA,78324,TOLIKARA,78439,WINA,0,0,0
78203,PAPUA,78324,TOLIKARA,78480,WONIKI,0,0,0
78203,PAPUA,78324,TOLIKARA,83896,WUGI,0,0,0
78203,PAPUA,78324,TOLIKARA,78424,WUNIM,0,0,0
78203,PAPUA,78324,TOLIKARA,83904,YUKO,0,0,0
78203,PAPUA,78324,TOLIKARA,83873,YUNERI,0,0,0
78203,PAPUA,78862,WAROPEN,84098,DEMBA,151,1963,2114
78203,PAPUA,78862,WAROPEN,78863,INGGERUS,281,924,1205
78203,PAPUA,78862,WAROPEN,78910,KIRIHI,552,2147,2699
78203,PAPUA,78862,WAROPEN,78877,MASIREI,99,1208,1307
78203,PAPUA,78862,WAROPEN,84097,OUDATE,94,2497,2591
78203,PAPUA,78862,WAROPEN,78886,RISEI SAYATI,139,934,1073
78203,PAPUA,78862,WAROPEN,84096,UREI FAISEI,980,4873,5853
78203,PAPUA,78862,WAROPEN,78890,WAPOGA,312,1315,1627
78203,PAPUA,78862,WAROPEN,78897,WAROPEN BAWAH,625,2441,3066
78203,PAPUA,81357,YAHUKIMO,81486,AMUMA,0,5899,5899
78203,PAPUA,81357,YAHUKIMO,81381,ANGGRUK,0,0,0
78203,PAPUA,81357,YAHUKIMO,81767,BOMELA,0,0,0
78203,PAPUA,81357,YAHUKIMO,81443,DEKAI,0,0,0
78203,PAPUA,81357,YAHUKIMO,81695,DIRWEMNA,0,0,0
78203,PAPUA,81357,YAHUKIMO,81844,DURAM,0,0,0
78203,PAPUA,81357,YAHUKIMO,81684,ENDOMEN,0,0,0
78203,PAPUA,81357,YAHUKIMO,81656,HEREAPINI,0,5540,5540
78203,PAPUA,81357,YAHUKIMO,81836,HILIPUK,0,0,0
78203,PAPUA,81357,YAHUKIMO,81519,HOGIO,2698,0,2698
78203,PAPUA,81357,YAHUKIMO,81701,HOLUON,0,2994,2994
78203,PAPUA,81357,YAHUKIMO,81806,KABIANGGAMA,0,0,0
78203,PAPUA,81357,YAHUKIMO,81857,KAYO,0,0,0
78203,PAPUA,81357,YAHUKIMO,81693,KONA,0,0,0
78203,PAPUA,81357,YAHUKIMO,81744,KORUPUN,0,0,0
78203,PAPUA,81357,YAHUKIMO,81602,KOSAREK,0,0,0
78203,PAPUA,81357,YAHUKIMO,81358,KURIMA,0,0,0
78203,PAPUA,81357,YAHUKIMO,81814,KWELEMDUA,0,0,0
78203,PAPUA,81357,YAHUKIMO,81825,KWIKMA,0,0,0
78203,PAPUA,81357,YAHUKIMO,81757,LANGDA,0,0,0
78203,PAPUA,81357,YAHUKIMO,81709,LOLAT,0,3545,3545
78203,PAPUA,81357,YAHUKIMO,81528,MUGI,0,5239,5239
78203,PAPUA,81357,YAHUKIMO,81500,MUSAIK,0,0,0
78203,PAPUA,81357,YAHUKIMO,81433,NALCA,0,0,0
78203,PAPUA,81357,YAHUKIMO,81391,NINIA,0,0,0
78203,PAPUA,81357,YAHUKIMO,81614,NIPSAN,0,4015,4015
78203,PAPUA,81357,YAHUKIMO,81456,OBIO,0,0,0
78203,PAPUA,81357,YAHUKIMO,81588,PANGGEMA,0,5877,5877
78203,PAPUA,81357,YAHUKIMO,81511,PASEMA,5475,0,5475
78203,PAPUA,81357,YAHUKIMO,81636,PRONGGOLI,0,5924,5924
78203,PAPUA,81357,YAHUKIMO,81682,PULDAMA,0,0,0
78203,PAPUA,81357,YAHUKIMO,81423,SAMENAGE,0,0,0
78203,PAPUA,81357,YAHUKIMO,81727,SELA,0,0,0
78203,PAPUA,81357,YAHUKIMO,81782,SEREDELA,0,0,0
78203,PAPUA,81357,YAHUKIMO,81402,SILIMO,0,0,0
78203,PAPUA,81357,YAHUKIMO,81543,SOBA,0,3812,3812
78203,PAPUA,81357,YAHUKIMO,81792,SOBAHAM,0,0,0
78203,PAPUA,81357,YAHUKIMO,81718,SOLOIKMA,0,0,0
78203,PAPUA,81357,YAHUKIMO,81865,SUMO,0,0,0
78203,PAPUA,81357,YAHUKIMO,81773,SUNTAMON,0,0,0
78203,PAPUA,81357,YAHUKIMO,81468,SURU SURU,0,0,0
78203,PAPUA,81357,YAHUKIMO,81672,TALAMBO,0,4491,4491
78203,PAPUA,81357,YAHUKIMO,81565,TANGMA,0,0,0
78203,PAPUA,81357,YAHUKIMO,81618,UBAHAK,0,9375,9375
78203,PAPUA,81357,YAHUKIMO,81660,UBALIHI,0,5695,5695
78203,PAPUA,81357,YAHUKIMO,81576,UKHA,0,0,0
78203,PAPUA,81357,YAHUKIMO,81645,WALMA,0,4763,4763
78203,PAPUA,81357,YAHUKIMO,81550,WERIMA,0,5797,5797
78203,PAPUA,81357,YAHUKIMO,81481,WUSAMA,0,0,0
78203,PAPUA,81357,YAHUKIMO,81654,YAHULIAMBUT,3703,0,3703
78203,PAPUA,81357,YAHUKIMO,81849,YOGOSEM,0,0,0
78203,PAPUA,79531,YALIMO,79542,ABENAHO,9895,12612,22507
78203,PAPUA,79531,YALIMO,79537,APALAPSILI,3152,7427,10579
78203,PAPUA,79531,YALIMO,79553,BENAWA,1310,9418,10728
78203,PAPUA,79531,YALIMO,79532,ELELIM,2919,6693,9612
78203,PAPUA,79531,YALIMO,79558,WELAREK,536,13900,14436
81877,PAPUA BARAT,82605,FAKFAK,82682,BOMBERAY,0,0,0
81877,PAPUA BARAT,82605,FAKFAK,82674,KARAS,0,0,0
81877,PAPUA BARAT,82605,FAKFAK,82641,KOKAS,0,0,0
81877,PAPUA BARAT,82605,FAKFAK,82692,KRAMONGMONGGA,0,0,0
81877,PAPUA BARAT,82605,FAKFAK,82707,TELUK PATIPI,0,0,0
81877,PAPUA BARAT,83194,KAIMANA,83215,BURUWAY,0,0,0
81877,PAPUA BARAT,83194,KAIMANA,83195,KAIMANA,0,0,0
81877,PAPUA BARAT,83194,KAIMANA,83258,KAMBRAU,0,0,0
81877,PAPUA BARAT,83194,KAIMANA,83226,TELUK ARGUNI ATAS,0,0,0
81877,PAPUA BARAT,83194,KAIMANA,83266,TELUK ARGUNI BAWAH,0,0,0
81877,PAPUA BARAT,83194,KAIMANA,83252,TELUK ETNA,0,0,0
81877,PAPUA BARAT,83194,KAIMANA,83282,YAMOR,0,0,0
81877,PAPUA BARAT,83289,KOTA SORONG,83290,SORONG,0,0,0
81877,PAPUA BARAT,83289,KOTA SORONG,83303,SORONG BARAT,0,0,0
81877,PAPUA BARAT,83289,KOTA SORONG,83309,SORONG KEPULAUAN,1440,2596,4036
81877,PAPUA BARAT,83289,KOTA SORONG,83296,SORONG TIMUR,6841,9561,16402
81877,PAPUA BARAT,83289,KOTA SORONG,83314,SORONG UTARA,0,0,0
81877,PAPUA BARAT,82154,MANOKWARI,82263,ANGGI,0,0,0
81877,PAPUA BARAT,82154,MANOKWARI,82509,ANGGI GIDA,195,1678,1873
81877,PAPUA BARAT,82154,MANOKWARI,82553,CATUBOUW,705,2073,2778
81877,PAPUA BARAT,82154,MANOKWARI,82532,DATARAN ISIM,114,1834,1948
81877,PAPUA BARAT,82154,MANOKWARI,82517,DIDOHU,0,0,0
81877,PAPUA BARAT,82154,MANOKWARI,82575,HINK,0,0,0
81877,PAPUA BARAT,82154,MANOKWARI,82349,MANOKWARI BARAT,16003,30074,46077
81877,PAPUA BARAT,82154,MANOKWARI,82391,MANOKWARI SELATAN,2796,6371,9167
81877,PAPUA BARAT,82154,MANOKWARI,82360,MANOKWARI TIMUR,771,3783,4554
81877,PAPUA BARAT,82154,MANOKWARI,82368,MANOKWARI UTARA,201,3085,3286
81877,PAPUA BARAT,82154,MANOKWARI,82205,MASNI,0,0,0
81877,PAPUA BARAT,82154,MANOKWARI,82501,MEMBEY,0,0,0
81877,PAPUA BARAT,82154,MANOKWARI,82298,MINYAMBOUW,0,0,0
81877,PAPUA BARAT,82154,MANOKWARI,82451,NENEY,62,1595,1657
81877,PAPUA BARAT,82154,MANOKWARI,82239,ORANSBARI,0,0,0
81877,PAPUA BARAT,82154,MANOKWARI,82188,PRAFI,0,0,0
81877,PAPUA BARAT,82154,MANOKWARI,82155,RANSIKI,1108,5685,6793
81877,PAPUA BARAT,82154,MANOKWARI,82472,SIDEY,0,0,0
81877,PAPUA BARAT,82154,MANOKWARI,82277,SURUREY,0,0,0
81877,PAPUA BARAT,82154,MANOKWARI,82489,TAIGE,0,2961,2961
81877,PAPUA BARAT,82154,MANOKWARI,82426,TANAH RUBUH,39,3459,3498
81877,PAPUA BARAT,82154,MANOKWARI,82410,TESTEGA,0,0,0
81877,PAPUA BARAT,82154,MANOKWARI,82467,TOHOTA,106,924,1030
81877,PAPUA BARAT,82154,MANOKWARI,82169,WARMARE,0,0,0
81877,PAPUA BARAT,81878,MAYBRAT,81879,AIFAT,1049,1250,2299
81877,PAPUA BARAT,81878,MAYBRAT,81911,AIFAT SELATAN,575,796,1371
81877,PAPUA BARAT,81878,MAYBRAT,81901,AIFAT TIMUR,392,353,745
81877,PAPUA BARAT,81878,MAYBRAT,83582,AIFAT TIMUR JAUH,199,242,441
81877,PAPUA BARAT,81878,MAYBRAT,83583,AIFAT TIMUR SELATAN,77,340,417
81877,PAPUA BARAT,81878,MAYBRAT,83581,AIFAT TIMUR TENGAH,573,441,1014
81877,PAPUA BARAT,81878,MAYBRAT,81890,AIFAT UTARA,761,1273,2034
81877,PAPUA BARAT,81878,MAYBRAT,81927,AITINYO,195,1649,1844
81877,PAPUA BARAT,81878,MAYBRAT,81919,AITINYO BARAT,306,584,890
81877,PAPUA BARAT,81878,MAYBRAT,83579,AITINYO RAYA,53,956,1009
81877,PAPUA BARAT,81878,MAYBRAT,83578,AITINYO TENGAH,201,804,1005
81877,PAPUA BARAT,81878,MAYBRAT,81940,AITINYO UTARA,143,933,1076
81877,PAPUA BARAT,81878,MAYBRAT,81951,AYAMARU,124,1717,1841
81877,PAPUA BARAT,81878,MAYBRAT,83571,AYAMARU BARAT,70,649,719
81877,PAPUA BARAT,81878,MAYBRAT,83574,AYAMARU JAYA,62,1191,1253
81877,PAPUA BARAT,81878,MAYBRAT,83573,AYAMARU SELATAN,245,1076,1321
81877,PAPUA BARAT,81878,MAYBRAT,83577,AYAMARU SELATAN JAYA,313,649,962
81877,PAPUA BARAT,81878,MAYBRAT,83572,AYAMARU TENGAH,269,1149,1418
81877,PAPUA BARAT,81878,MAYBRAT,81978,AYAMARU TIMUR,140,871,1011
81877,PAPUA BARAT,81878,MAYBRAT,83576,AYAMARU TIMUR SELATAN,118,540,658
81877,PAPUA BARAT,81878,MAYBRAT,81969,AYAMARU UTARA,778,1449,2227
81877,PAPUA BARAT,81878,MAYBRAT,83575,AYAMARU UTARA TIMUR,276,852,1128
81877,PAPUA BARAT,81878,MAYBRAT,81984,MARE,346,866,1212
81877,PAPUA BARAT,81878,MAYBRAT,83580,MARE SELATAN,698,252,950
81877,PAPUA BARAT,82850,RAJA AMPAT,82882,AYAU,0,0,0
81877,PAPUA BARAT,82850,RAJA AMPAT,83564,BATANTA SELATAN,0,0,0
81877,PAPUA BARAT,82850,RAJA AMPAT,83559,BATANTA UTARA,0,0,0
81877,PAPUA BARAT,82850,RAJA AMPAT,83563,KEPULAUAN AYAU,0,0,0
81877,PAPUA BARAT,82850,RAJA AMPAT,82960,KEPULAUAN SEMBILAN,0,0,0
81877,PAPUA BARAT,82850,RAJA AMPAT,82917,KOFIAU,0,0,0
81877,PAPUA BARAT,82850,RAJA AMPAT,83557,KOTA WAISAI,0,0,0
81877,PAPUA BARAT,82850,RAJA AMPAT,82922,MEOS MANSAR,0,0,0
81877,PAPUA BARAT,82850,RAJA AMPAT,82954,MISOOL BARAT,0,0,0
81877,PAPUA BARAT,82850,RAJA AMPAT,82938,MISOOL SELATAN,0,0,0
81877,PAPUA BARAT,82850,RAJA AMPAT,82890,MISOOL TIMUR,0,0,0
81877,PAPUA BARAT,82850,RAJA AMPAT,83560,SALAWATI BARAT,0,0,0
81877,PAPUA BARAT,82850,RAJA AMPAT,83561,SALAWATI TENGAH,0,0,0
81877,PAPUA BARAT,82850,RAJA AMPAT,82871,SALAWATI UTARA,0,0,0
81877,PAPUA BARAT,82850,RAJA AMPAT,83562,SUPNIN,0,0,0
81877,PAPUA BARAT,82850,RAJA AMPAT,82906,TELUK MAYALIBIT,0,0,0
81877,PAPUA BARAT,82850,RAJA AMPAT,83558,TIPLOL MAYALIBIT,0,0,0
81877,PAPUA BARAT,82850,RAJA AMPAT,82895,WAIGEO BARAT,0,0,0
81877,PAPUA BARAT,82850,RAJA AMPAT,82948,WAIGEO BARAT KEPULAUAN,0,0,0
81877,PAPUA BARAT,82850,RAJA AMPAT,82864,WAIGEO SELATAN,0,0,0
81877,PAPUA BARAT,82850,RAJA AMPAT,82901,WAIGEO TIMUR,0,0,0
81877,PAPUA BARAT,82850,RAJA AMPAT,82857,WAIGEO UTARA,0,0,0
81877,PAPUA BARAT,82850,RAJA AMPAT,82943,WARWARBOMI,0,0,0
81877,PAPUA BARAT,82022,SORONG,82059,AIMAS,6833,6967,13800
81877,PAPUA BARAT,82022,SORONG,82038,BERAUR,584,2096,2680
81877,PAPUA BARAT,82022,SORONG,82109,KLABOT,265,2245,2510
81877,PAPUA BARAT,82022,SORONG,82068,KLAMONO,1039,3196,4235
81877,PAPUA BARAT,82022,SORONG,82141,KLASO,30,1338,1368
81877,PAPUA BARAT,82022,SORONG,82117,KLAWAK,176,2019,2195
81877,PAPUA BARAT,82022,SORONG,82137,KLAYILI,53,961,1014
81877,PAPUA BARAT,82022,SORONG,82023,MAKBON,61,1315,1376
81877,PAPUA BARAT,82022,SORONG,82131,MARIAT,4378,2826,7204
81877,PAPUA BARAT,82022,SORONG,82127,MAUDUS,322,1057,1379
81877,PAPUA BARAT,82022,SORONG,82095,MAYAMUK,4256,2243,6499
81877,PAPUA BARAT,82022,SORONG,82146,MOISEGEN,743,829,1572
81877,PAPUA BARAT,82022,SORONG,82044,SALAWATI,4136,1497,5633
81877,PAPUA BARAT,82022,SORONG,82103,SALAWATI SELATAN,424,902,1326
81877,PAPUA BARAT,82022,SORONG,82082,SAYOSA,238,1661,1899
81877,PAPUA BARAT,82022,SORONG,82051,SEGET,483,1552,2035
81877,PAPUA BARAT,82022,SORONG,82088,SEGUN,286,810,1096
81877,PAPUA BARAT,82724,SORONG SELATAN,82845,FKOUR,216,466,682
81877,PAPUA BARAT,82724,SORONG SELATAN,82741,INANWATAN,431,1293,1724
81877,PAPUA BARAT,82724,SORONG SELATAN,82802,KAIS,420,1787,2207
81877,PAPUA BARAT,82724,SORONG SELATAN,82762,KOKODA,1956,3299,5255
81877,PAPUA BARAT,82724,SORONG SELATAN,82828,KOKODA UTARA,1014,890,1904
81877,PAPUA BARAT,82724,SORONG SELATAN,82815,KONDA,467,888,1355
81877,PAPUA BARAT,82724,SORONG SELATAN,82821,METEMANI,422,1468,1890
81877,PAPUA BARAT,82724,SORONG SELATAN,82778,MOSWAREN,760,1183,1943
81877,PAPUA BARAT,82724,SORONG SELATAN,82835,SAIFI,83,1514,1597
81877,PAPUA BARAT,82724,SORONG SELATAN,82749,SAWIAT,386,1979,2365
81877,PAPUA BARAT,82724,SORONG SELATAN,82785,SEREMUK,207,1007,1214
81877,PAPUA BARAT,82724,SORONG SELATAN,82725,TEMINABUAN,0,0,0
81877,PAPUA BARAT,82724,SORONG SELATAN,82793,WAYER,393,1077,1470
81877,PAPUA BARAT,81992,TAMBRAUW,82017,ABUN,0,0,0
81877,PAPUA BARAT,81992,TAMBRAUW,83566,AMBERBAKEN,0,0,0
81877,PAPUA BARAT,81992,TAMBRAUW,81993,FEF,0,0,0
81877,PAPUA BARAT,81992,TAMBRAUW,83567,KEBAR,0,0,0
81877,PAPUA BARAT,81992,TAMBRAUW,82006,KWOOR,0,0,0
81877,PAPUA BARAT,81992,TAMBRAUW,81995,MIYAH,0,0,0
81877,PAPUA BARAT,81992,TAMBRAUW,83570,MORAID,0,0,0
81877,PAPUA BARAT,81992,TAMBRAUW,83569,MUBRANI,0,0,0
81877,PAPUA BARAT,81992,TAMBRAUW,82009,SAUSAPOR,0,0,0
81877,PAPUA BARAT,81992,TAMBRAUW,83568,SENOPI,0,0,0
81877,PAPUA BARAT,81992,TAMBRAUW,83565,SYUJAK,0,0,0
81877,PAPUA BARAT,81992,TAMBRAUW,82001,YEMBUN,0,0,0
81877,PAPUA BARAT,82965,TELUK BINTUNI,82990,ARANDAY,957,377,1334
81877,PAPUA BARAT,82965,TELUK BINTUNI,83058,AROBA,443,1435,1878
81877,PAPUA BARAT,82965,TELUK BINTUNI,82985,BABO,778,1205,1983
81877,PAPUA BARAT,82965,TELUK BINTUNI,82966,BINTUNI,2959,7845,10804
81877,PAPUA BARAT,82965,TELUK BINTUNI,83069,BISCOOP,53,454,507
81877,PAPUA BARAT,82965,TELUK BINTUNI,83039,DATARAN BEIMES,23,958,981
81877,PAPUA BARAT,82965,TELUK BINTUNI,83011,FAFURWAR,6,869,875
81877,PAPUA BARAT,82965,TELUK BINTUNI,83052,KAITARO,66,532,598
81877,PAPUA BARAT,82965,TELUK BINTUNI,83082,KAMUNDAN,305,189,494
81877,PAPUA BARAT,82965,TELUK BINTUNI,83020,KURI,45,698,743
81877,PAPUA BARAT,82965,TELUK BINTUNI,83026,MANIMERI,1240,2011,3251
81877,PAPUA BARAT,82965,TELUK BINTUNI,83064,MASYETA,136,552,688
81877,PAPUA BARAT,82965,TELUK BINTUNI,82975,MERDEY,573,391,964
81877,PAPUA BARAT,82965,TELUK BINTUNI,83098,MEYADO,164,557,721
81877,PAPUA BARAT,82965,TELUK BINTUNI,83093,MOSKONA BARAT,5,757,762
81877,PAPUA BARAT,82965,TELUK BINTUNI,82995,MOSKONA SELATAN,154,800,954
81877,PAPUA BARAT,82965,TELUK BINTUNI,83103,MOSKONA TIMUR,706,779,1485
81877,PAPUA BARAT,82965,TELUK BINTUNI,83001,MOSKONA UTARA,187,1017,1204
81877,PAPUA BARAT,82965,TELUK BINTUNI,83046,SUMURI,1277,3953,5230
81877,PAPUA BARAT,82965,TELUK BINTUNI,83015,TEMBUNI,223,550,773
81877,PAPUA BARAT,82965,TELUK BINTUNI,83077,TOMU,1199,370,1569
81877,PAPUA BARAT,82965,TELUK BINTUNI,83033,TUHIBA,171,703,874
81877,PAPUA BARAT,82965,TELUK BINTUNI,83006,WAMESA,0,796,796
81877,PAPUA BARAT,82965,TELUK BINTUNI,83087,WERIAGAR,644,701,1345
81877,PAPUA BARAT,83107,TELUK WONDAMA,83168,KURI WAMESA,184,892,1076
81877,PAPUA BARAT,83107,TELUK WONDAMA,83151,NAIKERE,14,537,551
81877,PAPUA BARAT,83107,TELUK WONDAMA,83175,NIKIWAR,84,471,555
81877,PAPUA BARAT,83107,TELUK WONDAMA,83130,RASIEI,186,1545,1731
81877,PAPUA BARAT,83107,TELUK WONDAMA,83186,ROON,187,670,857
81877,PAPUA BARAT,83107,TELUK WONDAMA,83181,ROSWAR,10,513,523
81877,PAPUA BARAT,83107,TELUK WONDAMA,83144,RUMBERPON,87,961,1048
81877,PAPUA BARAT,83107,TELUK WONDAMA,83162,SOUG JAYA,13,438,451
81877,PAPUA BARAT,83107,TELUK WONDAMA,83125,TELUK DUAIRI,367,684,1051
81877,PAPUA BARAT,83107,TELUK WONDAMA,83140,WAMESA,25,532,557
81877,PAPUA BARAT,83107,TELUK WONDAMA,83108,WASIOR,1816,4941,6757
81877,PAPUA BARAT,83107,TELUK WONDAMA,83119,WINDESI,75,835,910
81877,PAPUA BARAT,83107,TELUK WONDAMA,83157,WONDIBOY,243,1085,1328
14086,RIAU,14630,BENGKALIS,14652,BANTAN,6261,12783,19044
14086,RIAU,14630,BENGKALIS,14631,BENGKALIS,16789,19492,36281
14086,RIAU,14630,BENGKALIS,14662,BUKIT BATU,7195,8878,16073
14086,RIAU,14630,BENGKALIS,14678,MANDAU,62864,48405,111269
14086,RIAU,14630,BENGKALIS,14727,PINGGIR,12781,29362,42143
14086,RIAU,14630,BENGKALIS,14694,RUPAT,4639,10921,15560
14086,RIAU,14630,BENGKALIS,14707,RUPAT UTARA,2010,4412,6422
14086,RIAU,14630,BENGKALIS,14713,SIAK KECIL,4122,6616,10738
14086,RIAU,14741,INDRAGIRI HILIR,14846,BATANG TUAKA,5321,4658,9979
14086,RIAU,14741,INDRAGIRI HILIR,14932,CONCONG,1902,2585,4487
14086,RIAU,14741,INDRAGIRI HILIR,14753,ENOK,5876,9762,15638
14086,RIAU,14741,INDRAGIRI HILIR,14858,GAUNG,3890,10251,14141
14086,RIAU,14741,INDRAGIRI HILIR,14790,GAUNG ANAK SERKA,3727,5167,8894
14086,RIAU,14741,INDRAGIRI HILIR,14812,KATEMAN,6148,11228,17376
14086,RIAU,14741,INDRAGIRI HILIR,14939,KEMPAS,7234,9230,16464
14086,RIAU,14741,INDRAGIRI HILIR,14875,KEMUNING,5547,9778,15325
14086,RIAU,14741,INDRAGIRI HILIR,14821,KERITANG,8712,19039,27751
14086,RIAU,14741,INDRAGIRI HILIR,14766,KUALA INDRAGIRI,2120,3762,5882
14086,RIAU,14741,INDRAGIRI HILIR,14799,MANDAH,6031,9066,15097
14086,RIAU,14741,INDRAGIRI HILIR,14887,PELANGIRAN,7530,10750,18280
14086,RIAU,14741,INDRAGIRI HILIR,14916,PULAU BURUNG,3662,6237,9899
14086,RIAU,14741,INDRAGIRI HILIR,14742,RETEH,6818,11872,18690
14086,RIAU,14741,INDRAGIRI HILIR,14948,SUNGAI BATANG,1866,3041,4907
14086,RIAU,14741,INDRAGIRI HILIR,14835,TANAH MERAH,4265,6252,10517
14086,RIAU,14741,INDRAGIRI HILIR,14902,TELUK BELENGKONG,1831,4209,6040
14086,RIAU,14741,INDRAGIRI HILIR,14775,TEMBILAHAN,16782,15154,31936
14086,RIAU,14741,INDRAGIRI HILIR,14870,TEMBILAHAN HULU,8262,9519,17781
14086,RIAU,14741,INDRAGIRI HILIR,14782,TEMPULING,6121,7074,13195
14086,RIAU,14414,INDRAGIRI HULU,14515,BATANG CENAKU,6179,10963,17142
14086,RIAU,14414,INDRAGIRI HULU,14536,BATANG GANGSAL,2930,8765,11695
14086,RIAU,14414,INDRAGIRI HULU,14619,BATANG PERANAP,1451,3724,5175
14086,RIAU,14414,INDRAGIRI HULU,14453,KELAYANG,5024,6316,11340
14086,RIAU,14414,INDRAGIRI HULU,14565,KUALA CENAKU,3081,2684,5765
14086,RIAU,14414,INDRAGIRI HULU,14547,LIRIK,4756,6406,11162
14086,RIAU,14414,INDRAGIRI HULU,14589,LUBUK BATU JAYA,4383,6048,10431
14086,RIAU,14414,INDRAGIRI HULU,14472,PASIR PENYU,7817,6499,14316
14086,RIAU,14414,INDRAGIRI HULU,14490,PERANAP,5137,7276,12413
14086,RIAU,14414,INDRAGIRI HULU,14599,RAKIT KULIM,2964,5331,8295
14086,RIAU,14414,INDRAGIRI HULU,14415,RENGAT,13895,7258,21153
14086,RIAU,14414,INDRAGIRI HULU,14434,RENGAT BARAT,10154,10050,20204
14086,RIAU,14414,INDRAGIRI HULU,14503,SIBERIDA,9303,12380,21683
14086,RIAU,14414,INDRAGIRI HULU,14576,SUNGAI LALA,2980,3760,6740
14086,RIAU,14166,KAMPAR,14167,BANGKINANG,13629,3037,16666
14086,RIAU,14166,KAMPAR,14358,BANGKINANG SEBERANG,11190,4604,15794
14086,RIAU,14166,KAMPAR,14400,GUNUNG SAHILAN,3496,5186,8682
14086,RIAU,14166,KAMPAR,14172,KAMPAR,21187,3084,24271
14086,RIAU,14166,KAMPAR,14234,KAMPAR KIRI,6538,6706,13244
14086,RIAU,14166,KAMPAR,14251,KAMPAR KIRI HILIR,2927,2378,5305
14086,RIAU,14166,KAMPAR,14266,KAMPAR KIRI HULU,3018,2676,5694
14086,RIAU,14166,KAMPAR,14388,KAMPAR KIRI TENGAH,6778,7583,14361
14086,RIAU,14166,KAMPAR,14373,KAMPAR TIMUR,9819,2174,11993
14086,RIAU,14166,KAMPAR,14380,KAMPAR UTARA,8313,1015,9328
14086,RIAU,14166,KAMPAR,14407,KOTO KAMPAR HULU,6013,3739,9752
14086,RIAU,14166,KAMPAR,14214,KUOK,8927,2144,11071
14086,RIAU,14166,KAMPAR,14368,PERHENTIAN RAJA,4377,3512,7889
14086,RIAU,14166,KAMPAR,14351,RUMBIO JAYA,6378,1933,8311
14086,RIAU,14166,KAMPAR,14344,SALO,7392,2835,10227
14086,RIAU,14166,KAMPAR,14221,SIAK HULU,26069,15156,41225
14086,RIAU,14166,KAMPAR,14185,TAMBANG,24850,7197,32047
14086,RIAU,14166,KAMPAR,14288,TAPUNG,20749,21824,42573
14086,RIAU,14166,KAMPAR,14313,TAPUNG HILIR,11596,14887,26483
14086,RIAU,14166,KAMPAR,14330,TAPUNG HULU,13569,23052,36621
14086,RIAU,14166,KAMPAR,14200,XIII KOTO KAMPAR,7865,3407,11272
14086,RIAU,14087,KEPULAUAN MERANTI,14144,MERBAU,2319,4747,7066
14086,RIAU,14087,KEPULAUAN MERANTI,83480,PULAUMERBAU,1839,4562,6401
14086,RIAU,14087,KEPULAUAN MERANTI,14121,RANGSANG,2581,6100,8681
14086,RIAU,14087,KEPULAUAN MERANTI,14105,RANGSANG BARAT,3045,5253,8298
14086,RIAU,14087,KEPULAUAN MERANTI,83483,RANGSANG PESISIR,2067,5108,7175
14086,RIAU,14087,KEPULAUAN MERANTI,83482,TASIK PUTRI PUYU,2003,5523,7526
14086,RIAU,14087,KEPULAUAN MERANTI,14088,TEBING TINGGI,11280,14905,26185
14086,RIAU,14087,KEPULAUAN MERANTI,14135,TEBING TINGGI BARAT,2888,4905,7793
14086,RIAU,14087,KEPULAUAN MERANTI,83481,TEBING TINGGI TIMUR,1589,4186,5775
14086,RIAU,15846,KOTA DUMAI,15868,BUKIT KAPUR,7090,10694,17784
14086,RIAU,15846,KOTA DUMAI,15847,DUMAI BARAT,8634,8526,17160
14086,RIAU,15846,KOTA DUMAI,83421,DUMAI KOTA,10345,9291,19636
14086,RIAU,15846,KOTA DUMAI,83422,DUMAI SELATAN,12695,9708,22403
14086,RIAU,15846,KOTA DUMAI,15858,DUMAI TIMUR,12643,13952,26595
14086,RIAU,15846,KOTA DUMAI,15880,MEDANG KAMPAI,2160,2569,4729
14086,RIAU,15846,KOTA DUMAI,15874,SUNGAI SEMBILAN,3944,10744,14688
14086,RIAU,15775,KOTA PEKANBARU,15813,BUKIT RAYA,30135,10460,40595
14086,RIAU,15775,KOTA PEKANBARU,15795,LIMA PULUH,10507,9741,20248
14086,RIAU,15775,KOTA PEKANBARU,15823,MARPOYAN DAMAI,37088,15061,52149
14086,RIAU,15775,KOTA PEKANBARU,15834,PAYUNG SEKAKI,21464,18553,40017
14086,RIAU,15775,KOTA PEKANBARU,15784,PEKANBARU KOTA,8588,2758,11346
14086,RIAU,15775,KOTA PEKANBARU,15807,RUMBAI,16179,11664,27843
14086,RIAU,15775,KOTA PEKANBARU,15839,RUMBAI PESISIR,24020,8242,32262
14086,RIAU,15775,KOTA PEKANBARU,15791,SAIL,7270,2552,9822
14086,RIAU,15775,KOTA PEKANBARU,15800,SENAPELAN,10511,6906,17417
14086,RIAU,15775,KOTA PEKANBARU,15776,SUKAJADI,14226,6524,20750
14086,RIAU,15775,KOTA PEKANBARU,15818,TAMPAN,46591,16585,63176
14086,RIAU,15775,KOTA PEKANBARU,15829,TENAYAN RAYA,35014,20133,55147
14086,RIAU,15553,KUANTAN SINGINGI,15668,BENAI,4613,3492,8105
14086,RIAU,15553,KUANTAN SINGINGI,15655,CERENTI,3551,3203,6754
14086,RIAU,15553,KUANTAN SINGINGI,15695,GUNUNGTOAR,4098,2314,6412
14086,RIAU,15553,KUANTAN SINGINGI,15763,HULU KUANTAN,1913,1913,3826
14086,RIAU,15553,KUANTAN SINGINGI,15751,INUMAN,2407,4376,6783
14086,RIAU,15553,KUANTAN SINGINGI,15626,KUANTAN HILIR,3500,3617,7117
14086,RIAU,15553,KUANTAN SINGINGI,83477,KUANTAN HILIR SEBERANG,2058,4193,6251
14086,RIAU,15553,KUANTAN SINGINGI,15554,KUANTAN MUDIK,6920,4427,11347
14086,RIAU,15553,KUANTAN SINGINGI,15585,KUANTAN TENGAH,13599,9329,22928
14086,RIAU,15553,KUANTAN SINGINGI,15737,LOGAS TANAH DARAT,4216,6376,10592
14086,RIAU,15553,KUANTAN SINGINGI,15722,PANGEAN,4788,4219,9007
14086,RIAU,15553,KUANTAN SINGINGI,83479,PUCUK RANTAU,1783,2715,4498
14086,RIAU,15553,KUANTAN SINGINGI,83478,SENTAJO RAYA,7298,7780,15078
14086,RIAU,15553,KUANTAN SINGINGI,15612,SINGINGI,6743,7972,14715
14086,RIAU,15553,KUANTAN SINGINGI,15709,SINGINGI HILIR,7107,10333,17440
14086,RIAU,14955,PELALAWAN,15074,BANDAR PETALANGAN,3584,4257,7841
14086,RIAU,14955,PELALAWAN,15068,BANDAR SEI KIJANG,3431,4035,7466
14086,RIAU,14955,PELALAWAN,15036,BUNUT,2619,3288,5907
14086,RIAU,14955,PELALAWAN,15025,KERUMUTAN,6079,5294,11373
14086,RIAU,14955,PELALAWAN,15057,KUALA KAMPAR,2199,5971,8170
14086,RIAU,14955,PELALAWAN,15006,LANGGAM,4440,6402,10842
14086,RIAU,14955,PELALAWAN,14968,PANGKALAN KERINCI,18025,15584,33609
14086,RIAU,14955,PELALAWAN,14977,PANGKALAN KURAS,9447,13425,22872
14086,RIAU,14955,PELALAWAN,14995,PANGKALAN LESUNG,5190,7422,12612
14086,RIAU,14955,PELALAWAN,15015,PELALAWAN,2747,3972,6719
14086,RIAU,14955,PELALAWAN,15047,TELUK MERANTI,2956,4559,7515
14086,RIAU,14955,PELALAWAN,14956,UKUI,6226,11287,17513
14086,RIAU,15254,ROKAN HILIR,15314,BAGAN SINEMBAH,28025,36760,64785
14086,RIAU,15254,ROKAN HILIR,15271,BANGKO,19000,18967,37967
14086,RIAU,15254,ROKAN HILIR,15369,BANGKO PUSAKO,8998,17643,26641
14086,RIAU,15254,ROKAN HILIR,15390,BATU HAMPAR,1519,2243,3762
14086,RIAU,15254,ROKAN HILIR,15255,KUBU,3811,6624,10435
14086,RIAU,15254,ROKAN HILIR,83476,KUBU BABUSSALAM,3401,6403,9804
14086,RIAU,15254,ROKAN HILIR,15338,PASIR LIMAU KAPAS,4920,10135,15055
14086,RIAU,15254,ROKAN HILIR,15401,PEKAITAN,1990,6877,8867
14086,RIAU,15254,ROKAN HILIR,15350,PUJUD,11948,22239,34187
14086,RIAU,15254,ROKAN HILIR,15396,RANTAU KOPAR,1853,1322,3175
14086,RIAU,15254,ROKAN HILIR,15301,RIMBA MELINTANG,6396,10380,16776
14086,RIAU,15254,ROKAN HILIR,15383,SIMPANG KANAN,5009,7837,12846
14086,RIAU,15254,ROKAN HILIR,15345,SINABOI,2307,4039,6346
14086,RIAU,15254,ROKAN HILIR,15287,TANAH PUTIH,11955,14995,26950
14086,RIAU,15254,ROKAN HILIR,15363,TANAH PUTIH TANJUNG MELAWAN,3084,3173,6257
14086,RIAU,15087,ROKAN HULU,15203,BANGUN PURBA,4772,4503,9275
14086,RIAU,15087,ROKAN HULU,15228,BONAI DARUSSALAM,4331,7374,11705
14086,RIAU,15087,ROKAN HULU,15221,KABUN,5662,6036,11698
14086,RIAU,15087,ROKAN HULU,15137,KEPENUHAN,6899,3528,10427
14086,RIAU,15087,ROKAN HULU,15242,KEPENUHAN HULU,4936,3645,8581
14086,RIAU,15087,ROKAN HULU,15148,KUNTO DARUSSALAM,9138,9687,18825
14086,RIAU,15087,ROKAN HULU,15236,PAGARAN TAPAH DARUSSALAM,2472,2610,5082
14086,RIAU,15087,ROKAN HULU,15248,PENDALIAN IV KOTO,3029,3031,6060
14086,RIAU,15087,ROKAN HULU,15109,RAMBAH,16335,5770,22105
14086,RIAU,15087,ROKAN HULU,15177,RAMBAH HILIR,10506,9196,19702
14086,RIAU,15087,ROKAN HULU,15162,RAMBAH SAMO,8552,7015,15567
14086,RIAU,15087,ROKAN HULU,15094,ROKAN IV KOTO,6808,4731,11539
14086,RIAU,15087,ROKAN HULU,15124,TAMBUSAI,9690,15701,25391
14086,RIAU,15087,ROKAN HULU,15191,TAMBUSAI UTARA,10511,27182,37693
14086,RIAU,15087,ROKAN HULU,15211,TANDUN,6095,7593,13688
14086,RIAU,15087,ROKAN HULU,15088,UJUNG BATU,10220,8410,18630
14086,RIAU,15412,SIAK,15488,BUNGA RAYA,5464,6569,12033
14086,RIAU,15412,SIAK,15463,DAYUN,5753,7306,13059
14086,RIAU,15412,SIAK,15510,KANDIS,9204,18538,27742
14086,RIAU,15412,SIAK,15475,KERINCI KANAN,4978,6490,11468
14086,RIAU,15412,SIAK,15499,KOTO GASIB,4646,3688,8334
14086,RIAU,15412,SIAK,15521,LUBUK DALAM,3304,5382,8686
14086,RIAU,15412,SIAK,15537,MEMPURA,4380,2374,6754
14086,RIAU,15412,SIAK,15438,MINAS,5636,5502,11138
14086,RIAU,15412,SIAK,15545,PUSAKO,1768,1188,2956
14086,RIAU,15412,SIAK,15528,SABAK AUH,2828,2668,5496
14086,RIAU,15412,SIAK,15413,SIAK,6738,4063,10801
14086,RIAU,15412,SIAK,15422,SUNGAI APIT,5613,7568,13181
14086,RIAU,15412,SIAK,15453,SUNGAI MANDAU,2029,1366,3395
14086,RIAU,15412,SIAK,15444,TUALANG,27533,17667,45200
75425,SULAWESI BARAT,76047,MAJENE,76048,BANGGAE,5096,15333,20429
75425,SULAWESI BARAT,76047,MAJENE,76090,BANGGAE TIMUR,3935,11203,15138
75425,SULAWESI BARAT,76047,MAJENE,76068,MALUNDA,1787,6936,8723
75425,SULAWESI BARAT,76047,MAJENE,76053,PAMBOANG,2158,9094,11252
75425,SULAWESI BARAT,76047,MAJENE,76061,SENDANA,2895,8480,11375
75425,SULAWESI BARAT,76047,MAJENE,76080,TAMMERODO SENDANA,1240,4649,5889
75425,SULAWESI BARAT,76047,MAJENE,76085,TUBO SENDANA,1160,3598,4758
75425,SULAWESI BARAT,76047,MAJENE,76075,ULUMUNDA,900,3560,4460
75425,SULAWESI BARAT,75670,MAMASA,75693,ARALLE,1561,3706,5267
75425,SULAWESI BARAT,75670,MAMASA,75832,BALLA,547,3476,4023
75425,SULAWESI BARAT,75670,MAMASA,75811,BAMBANG,1516,6431,7947
75425,SULAWESI BARAT,75670,MAMASA,83761,BUNTUMALANGKA,2397,2876,5273
75425,SULAWESI BARAT,75670,MAMASA,75716,MAMASA,1756,9079,10835
75425,SULAWESI BARAT,75670,MAMASA,75671,MAMBI,2024,4690,6714
75425,SULAWESI BARAT,75670,MAMASA,83762,MEHALAAN,809,2069,2878
75425,SULAWESI BARAT,75670,MAMASA,75769,MESSAWA,513,3246,3759
75425,SULAWESI BARAT,75670,MAMASA,75841,NOSU,552,2539,3091
75425,SULAWESI BARAT,75670,MAMASA,75729,PANA,1278,4253,5531
75425,SULAWESI BARAT,75670,MAMASA,75854,RANTEBULAHAN TIMUR,625,3544,4169
75425,SULAWESI BARAT,75670,MAMASA,75779,SESENAPADANG,690,3257,3947
75425,SULAWESI BARAT,75670,MAMASA,75758,SUMARORONG,1287,4341,5628
75425,SULAWESI BARAT,75670,MAMASA,75803,TABANG,729,1788,2517
75425,SULAWESI BARAT,75670,MAMASA,75743,TABULAHAN,1439,6337,7776
75425,SULAWESI BARAT,75670,MAMASA,75790,TANDUK KALUA,1107,3168,4275
75425,SULAWESI BARAT,75670,MAMASA,75849,TAWALIAN,880,2856,3736
75425,SULAWESI BARAT,75502,MAMUJU,75660,BONEHAU,0,0,0
75425,SULAWESI BARAT,75502,MAMUJU,75522,KALUKKU,0,0,0
75425,SULAWESI BARAT,75502,MAMUJU,75536,KALUMPANG,0,0,0
75425,SULAWESI BARAT,75502,MAMUJU,75605,KAROSSA,0,0,0
75425,SULAWESI BARAT,75502,MAMUJU,75503,MAMUJU,0,0,0
75425,SULAWESI BARAT,75502,MAMUJU,75561,PANGALE,0,0,0
75425,SULAWESI BARAT,75502,MAMUJU,75571,PAPALANG,0,0,0
75425,SULAWESI BARAT,75502,MAMUJU,75581,SAMPAGA,0,0,0
75425,SULAWESI BARAT,75502,MAMUJU,75632,SIMBORO DAN KEPULAUAN,0,0,0
75425,SULAWESI BARAT,75502,MAMUJU,75512,TAPALANG,0,0,0
75425,SULAWESI BARAT,75502,MAMUJU,75643,TAPALANG BARAT,0,0,0
75425,SULAWESI BARAT,75502,MAMUJU,75651,TOBADAK,0,0,0
75425,SULAWESI BARAT,75502,MAMUJU,75617,TOMMO,0,0,0
75425,SULAWESI BARAT,75502,MAMUJU,75589,TOPOYO,0,0,0
75425,SULAWESI BARAT,75426,MAMUJU UTARA,75484,BAMBAIRA,1083,2774,3857
75425,SULAWESI BARAT,75426,MAMUJU UTARA,75427,BAMBALAMOTU,2610,5562,8172
75425,SULAWESI BARAT,75426,MAMUJU UTARA,75441,BARAS,1772,6083,7855
75425,SULAWESI BARAT,75426,MAMUJU UTARA,75465,BULU TABA,1138,3789,4927
75425,SULAWESI BARAT,75426,MAMUJU UTARA,75454,DAPURANG,674,5534,6208
75425,SULAWESI BARAT,75426,MAMUJU UTARA,75460,DURIPOKU,607,1802,2409
75425,SULAWESI BARAT,75426,MAMUJU UTARA,75494,LARIANG,626,2498,3124
75425,SULAWESI BARAT,75426,MAMUJU UTARA,75434,PASANGKAYU,2828,8261,11089
75425,SULAWESI BARAT,75426,MAMUJU UTARA,75479,PEDONGGA,1280,2178,3458
75425,SULAWESI BARAT,75426,MAMUJU UTARA,75489,SARJO,997,2237,3234
75425,SULAWESI BARAT,75426,MAMUJU UTARA,75448,SARUDU,1541,5106,6647
75425,SULAWESI BARAT,75426,MAMUJU UTARA,75473,TIKKE RAYA,1753,5009,6762
75425,SULAWESI BARAT,75863,POLEWALI MANDAR,76028,ALLU,2547,3695,6242
75425,SULAWESI BARAT,75863,POLEWALI MANDAR,76014,ANREAPI,1398,3518,4916
75425,SULAWESI BARAT,75863,POLEWALI MANDAR,76002,BALANIPA,3782,8701,12483
75425,SULAWESI BARAT,75863,POLEWALI MANDAR,75931,BINUANG,3789,11784,15573
75425,SULAWESI BARAT,75863,POLEWALI MANDAR,76037,BULO,1512,4050,5562
75425,SULAWESI BARAT,75863,POLEWALI MANDAR,75873,CAMPALAGIAN,8922,16828,25750
75425,SULAWESI BARAT,75863,POLEWALI MANDAR,75990,LIMBORO,3732,5292,9024
75425,SULAWESI BARAT,75863,POLEWALI MANDAR,75978,LUYO,4264,8575,12839
75425,SULAWESI BARAT,75863,POLEWALI MANDAR,75957,MAPILLI,4620,9179,13799
75425,SULAWESI BARAT,75863,POLEWALI MANDAR,76020,MATAKALI,3423,7550,10973
75425,SULAWESI BARAT,75863,POLEWALI MANDAR,75970,MATANGNGA,1040,1425,2465
75425,SULAWESI BARAT,75863,POLEWALI MANDAR,75907,POLEWALI,8007,18529,26536
75425,SULAWESI BARAT,75863,POLEWALI MANDAR,75942,TAPANGO,3682,7334,11016
75425,SULAWESI BARAT,75863,POLEWALI MANDAR,75864,TINAMBUNG,3624,8106,11730
75425,SULAWESI BARAT,75863,POLEWALI MANDAR,75917,TUTAR,2839,6572,9411
75425,SULAWESI BARAT,75863,POLEWALI MANDAR,75892,WONOMULYO,10196,15291,25487
69268,SULAWESI SELATAN,69668,BANTAENG,69681,BANTAENG,8860,9834,18694
69268,SULAWESI SELATAN,69668,BANTAENG,69669,BISSAPPU,6908,9192,16100
69268,SULAWESI SELATAN,69668,BANTAENG,69691,EREMERASA,3516,4623,8139
69268,SULAWESI SELATAN,69668,BANTAENG,69730,GANTARANG KEKE,2392,5280,7672
69268,SULAWESI SELATAN,69668,BANTAENG,69712,PAJUKUKANG,6618,6401,13019
69268,SULAWESI SELATAN,69668,BANTAENG,69737,SINOA,2876,3228,6104
69268,SULAWESI SELATAN,69668,BANTAENG,69701,TOMPO BULU,3287,7684,10971
69268,SULAWESI SELATAN,69668,BANTAENG,69723,ULUERE,1946,3413,5359
69268,SULAWESI SELATAN,70873,BARRU,70928,BALUSU,1184,9051,10235
69268,SULAWESI SELATAN,70873,BARRU,70893,BARRU,3412,18125,21537
69268,SULAWESI SELATAN,70873,BARRU,70912,MALLUSETASI,1780,12656,14436
69268,SULAWESI SELATAN,70873,BARRU,70921,PUJANANTING,1277,4821,6098
69268,SULAWESI SELATAN,70873,BARRU,70904,SOPPENG RIAJA,1715,8056,9771
69268,SULAWESI SELATAN,70873,BARRU,70874,TANETE RIAJA,1604,10629,12233
69268,SULAWESI SELATAN,70873,BARRU,70882,TANETE RILAU,2818,15753,18571
69268,SULAWESI SELATAN,70239,BONE,70508,AJANGALE,1722,13045,14767
69268,SULAWESI SELATAN,70239,BONE,70590,AMALI,1517,10926,12443
69268,SULAWESI SELATAN,70239,BONE,70471,AWANGPONE,1104,15895,16999
69268,SULAWESI SELATAN,70239,BONE,70374,BAREBBO,1546,13343,14889
69268,SULAWESI SELATAN,70239,BONE,70618,BENGO,1468,12699,14167
69268,SULAWESI SELATAN,70239,BONE,70240,BONTOCANI,1630,6827,8457
69268,SULAWESI SELATAN,70239,BONE,70546,CENRANA,939,12692,13631
69268,SULAWESI SELATAN,70239,BONE,70393,CINA,1861,12503,14364
69268,SULAWESI SELATAN,70239,BONE,70523,DUA BOCCOE,2011,14928,16939
69268,SULAWESI SELATAN,70239,BONE,70252,KAHU,3507,16801,20308
69268,SULAWESI SELATAN,70239,BONE,70273,KAJUARA,4609,12523,17132
69268,SULAWESI SELATAN,70239,BONE,70426,LAMURU,1112,11772,12884
69268,SULAWESI SELATAN,70239,BONE,70416,LAPPARIAJA,1454,12647,14101
69268,SULAWESI SELATAN,70239,BONE,70313,LIBURENG,2307,14427,16734
69268,SULAWESI SELATAN,70239,BONE,70334,MARE,2586,10283,12869
69268,SULAWESI SELATAN,70239,BONE,70455,PALAKKA,1891,10641,12532
69268,SULAWESI SELATAN,70239,BONE,70628,PATIMPENG,1568,6522,8090
69268,SULAWESI SELATAN,70239,BONE,70406,PONRE,803,6627,7430
69268,SULAWESI SELATAN,70239,BONE,70292,SALOMEKKO,1598,5623,7221
69268,SULAWESI SELATAN,70239,BONE,70353,SIBULUE,1776,15784,17560
69268,SULAWESI SELATAN,70239,BONE,70563,TANETE RIATTANG,4234,21627,25861
69268,SULAWESI SELATAN,70239,BONE,70572,TANETE RIATTANG BARAT,3384,18438,21822
69268,SULAWESI SELATAN,70239,BONE,70581,TANETE RIATTANG TIMUR,2321,18770,21091
69268,SULAWESI SELATAN,70239,BONE,70490,TELLU SIATTINGE,2065,19366,21431
69268,SULAWESI SELATAN,70239,BONE,70606,TELLULIMPOE,1033,7185,8218
69268,SULAWESI SELATAN,70239,BONE,70301,TONRA,1034,5924,6958
69268,SULAWESI SELATAN,70239,BONE,70439,ULAWENG,2733,11948,14681
69268,SULAWESI SELATAN,69531,BULUKUMBA,69563,BONTO BAHARI,2094,9419,11513
69268,SULAWESI SELATAN,69531,BULUKUMBA,69572,BONTO TIRO,2837,9824,12661
69268,SULAWESI SELATAN,69531,BULUKUMBA,69614,BULUKUMPA,6264,20696,26960
69268,SULAWESI SELATAN,69531,BULUKUMBA,69532,GANTARANG,11986,24716,36702
69268,SULAWESI SELATAN,69531,BULUKUMBA,69585,HERLANG,2889,9719,12608
69268,SULAWESI SELATAN,69531,BULUKUMBA,69594,KAJANG,5785,16607,22392
69268,SULAWESI SELATAN,69531,BULUKUMBA,69631,KINDANG,4160,10722,14882
69268,SULAWESI SELATAN,69531,BULUKUMBA,69654,RILAUALE,4529,15787,20316
69268,SULAWESI SELATAN,69531,BULUKUMBA,69553,UJUNG BULU,7224,15716,22940
69268,SULAWESI SELATAN,69531,BULUKUMBA,69641,UJUNGLOE,5202,14366,19568
69268,SULAWESI SELATAN,71437,ENREKANG,71512,ALLA,4622,5945,10567
69268,SULAWESI SELATAN,71437,ENREKANG,71496,ANGGERAJA,5083,8077,13160
69268,SULAWESI SELATAN,71437,ENREKANG,71480,BARAKA,5530,5745,11275
69268,SULAWESI SELATAN,71437,ENREKANG,71573,BAROKO,1914,3501,5415
69268,SULAWESI SELATAN,71437,ENREKANG,71521,BUNGIN,1076,1491,2567
69268,SULAWESI SELATAN,71437,ENREKANG,71557,BUNTU BATU,2592,4570,7162
69268,SULAWESI SELATAN,71437,ENREKANG,71528,CENDANA,1891,2737,4628
69268,SULAWESI SELATAN,71437,ENREKANG,71536,CURIO,3004,4628,7632
69268,SULAWESI SELATAN,71437,ENREKANG,71461,ENREKANG,6609,10063,16672
69268,SULAWESI SELATAN,71437,ENREKANG,71438,MAIWA,3733,8964,12697
69268,SULAWESI SELATAN,71437,ENREKANG,71548,MALUA,2055,2152,4207
69268,SULAWESI SELATAN,71437,ENREKANG,71566,MASALLE,1701,4537,6238
69268,SULAWESI SELATAN,69962,GOWA,69978,BAJENG,14734,21661,36395
69268,SULAWESI SELATAN,69962,GOWA,70141,BAJENG BARAT,4873,9911,14784
69268,SULAWESI SELATAN,69962,GOWA,70091,BAROMBONG,6855,13887,20742
69268,SULAWESI SELATAN,69962,GOWA,70079,BIRINGBULU,7248,12643,19891
69268,SULAWESI SELATAN,69962,GOWA,70116,BONTOLEMPANGANG,2717,5819,8536
69268,SULAWESI SELATAN,69962,GOWA,70018,BONTOMARANNU,6480,10945,17425
69268,SULAWESI SELATAN,69962,GOWA,69963,BONTONOMPO,11232,13790,25022
69268,SULAWESI SELATAN,69962,GOWA,70125,BONTONOMPO SELATAN,6763,10815,17578
69268,SULAWESI SELATAN,69962,GOWA,70060,BUNGAYA,2469,6283,8752
69268,SULAWESI SELATAN,69962,GOWA,70108,MANUJU,3165,5147,8312
69268,SULAWESI SELATAN,69962,GOWA,70028,PALANGGA,19477,35741,55218
69268,SULAWESI SELATAN,69962,GOWA,70010,PARANGLOE,2983,6524,9507
69268,SULAWESI SELATAN,69962,GOWA,70135,PARIGI,2045,5618,7663
69268,SULAWESI SELATAN,69962,GOWA,70099,PATTALASANG,3730,9667,13397
69268,SULAWESI SELATAN,69962,GOWA,70045,SOMBA UPU,23272,42938,66210
69268,SULAWESI SELATAN,69962,GOWA,70002,TINGGIMONCONG,3829,9074,12903
69268,SULAWESI SELATAN,69962,GOWA,70069,TOMBOLOPAO,4535,9677,14212
69268,SULAWESI SELATAN,69962,GOWA,69993,TOMPOBULLU,5216,11485,16701
69268,SULAWESI SELATAN,69744,JENEPONTO,69839,ARUNGKEKE,6794,2857,9651
69268,SULAWESI SELATAN,69744,JENEPONTO,69745,BANGKALA,10648,16105,26753
69268,SULAWESI SELATAN,69744,JENEPONTO,69805,BANGKALA BARAT,4761,7620,12381
69268,SULAWESI SELATAN,69744,JENEPONTO,69787,BATANG,6721,2840,9561
69268,SULAWESI SELATAN,69744,JENEPONTO,69773,BINAMU,14087,11962,26049
69268,SULAWESI SELATAN,69744,JENEPONTO,69814,BONTORAMBA,8075,8828,16903
69268,SULAWESI SELATAN,69744,JENEPONTO,69794,KELARA,7132,4960,12092
69268,SULAWESI SELATAN,69744,JENEPONTO,69847,RUMBIA,4503,8295,12798
69268,SULAWESI SELATAN,69744,JENEPONTO,69760,TAMALATEA,9203,9797,19000
69268,SULAWESI SELATAN,69744,JENEPONTO,69860,TAROWANG,6200,5059,11259
69268,SULAWESI SELATAN,69744,JENEPONTO,69827,TURATEA,7698,6708,14406
69268,SULAWESI SELATAN,69442,KEPULAUAN SELAYAR,69443,BENTENG,3631,6539,10170
69268,SULAWESI SELATAN,69442,KEPULAUAN SELAYAR,69447,BONTOHARU,2678,4257,6935
69268,SULAWESI SELATAN,69442,KEPULAUAN SELAYAR,69469,BONTOMANAI,2655,4820,7475
69268,SULAWESI SELATAN,69442,KEPULAUAN SELAYAR,69456,BONTOMATENE,2857,4583,7440
69268,SULAWESI SELATAN,69442,KEPULAUAN SELAYAR,69478,BONTOSIKUYU,2825,5228,8053
69268,SULAWESI SELATAN,69442,KEPULAUAN SELAYAR,69524,BUKI,1647,2092,3739
69268,SULAWESI SELATAN,69442,KEPULAUAN SELAYAR,69513,PASILAMBENA,1884,1536,3420
69268,SULAWESI SELATAN,69442,KEPULAUAN SELAYAR,69497,PASIMARANNU,2434,2195,4629
69268,SULAWESI SELATAN,69442,KEPULAUAN SELAYAR,69490,PASIMASUNGGU,1962,1822,3784
69268,SULAWESI SELATAN,69442,KEPULAUAN SELAYAR,69519,PASIMASUNGGU TIMUR,1672,1854,3526
69268,SULAWESI SELATAN,69442,KEPULAUAN SELAYAR,69504,TAKA BONERATE,3095,2617,5712
69268,SULAWESI SELATAN,72309,KOTA MAKASSAR,72434,BIRINGKANAYA,25507,57225,82732
69268,SULAWESI SELATAN,72309,KOTA MAKASSAR,72369,BONTOALA,5664,20158,25822
69268,SULAWESI SELATAN,72309,KOTA MAKASSAR,72334,MAKASAR,10666,28272,38938
69268,SULAWESI SELATAN,72309,KOTA MAKASSAR,72320,MAMAJANG,8957,17778,26735
69268,SULAWESI SELATAN,72309,KOTA MAKASSAR,72442,MANGGALA,17896,42748,60644
69268,SULAWESI SELATAN,72309,KOTA MAKASSAR,72310,MARISO,9636,17432,27068
69268,SULAWESI SELATAN,72309,KOTA MAKASSAR,72411,PANAKUKKANG,18437,45870,64307
69268,SULAWESI SELATAN,72309,KOTA MAKASSAR,72449,RAPPOCINI,23014,50226,73240
69268,SULAWESI SELATAN,72309,KOTA MAKASSAR,72382,TALLO,16709,45729,62438
69268,SULAWESI SELATAN,72309,KOTA MAKASSAR,72460,TAMALANREA,15215,29906,45121
69268,SULAWESI SELATAN,72309,KOTA MAKASSAR,72423,TAMALATE,23292,51303,74595
69268,SULAWESI SELATAN,72309,KOTA MAKASSAR,72349,UJUNG PANDANG,3409,10255,13664
69268,SULAWESI SELATAN,72309,KOTA MAKASSAR,72398,UJUNG TANAH,5646,17706,23352
69268,SULAWESI SELATAN,72309,KOTA MAKASSAR,72360,WAJO,2845,12745,15590
69268,SULAWESI SELATAN,72493,KOTA PALOPO,72545,BARA,4772,7403,12175
69268,SULAWESI SELATAN,72493,KOTA PALOPO,72540,MUNGKAJANG,1184,2704,3888
69268,SULAWESI SELATAN,72493,KOTA PALOPO,72535,SENDANA,1057,1987,3044
69268,SULAWESI SELATAN,72493,KOTA PALOPO,72513,TELLUWANUA,2517,3691,6208
69268,SULAWESI SELATAN,72493,KOTA PALOPO,72494,WARA,4667,9394,14061
69268,SULAWESI SELATAN,72493,KOTA PALOPO,72529,WARA BARAT,1870,3155,5025
69268,SULAWESI SELATAN,72493,KOTA PALOPO,72508,WARA SELATAN,1634,3401,5035
69268,SULAWESI SELATAN,72493,KOTA PALOPO,72521,WARA TIMUR,4804,10468,15272
69268,SULAWESI SELATAN,72493,KOTA PALOPO,72501,WARA UTARA,3184,6299,9483
69268,SULAWESI SELATAN,72467,KOTA PARE PARE,72468,BACUKIKI,2211,6414,8625
69268,SULAWESI SELATAN,72467,KOTA PARE PARE,72486,BACUKIKI BARAT,5272,15822,21094
69268,SULAWESI SELATAN,72467,KOTA PARE PARE,72478,SOREANG,5877,17060,22937
69268,SULAWESI SELATAN,72467,KOTA PARE PARE,72472,UJUNG,4720,11915,16635
69268,SULAWESI SELATAN,71579,LUWU,71633,BAJO,3901,5518,9419
69268,SULAWESI SELATAN,71579,LUWU,71804,BAJO BARAT,1463,3510,4973
69268,SULAWESI SELATAN,71579,LUWU,71580,BASSE SANGTEMPE,705,3221,3926
69268,SULAWESI SELATAN,71579,LUWU,83763,BASSE SANGTEMPE UTARA,807,3394,4201
69268,SULAWESI SELATAN,71579,LUWU,71667,BELOPA,3004,5845,8849
69268,SULAWESI SELATAN,71579,LUWU,71748,BELOPA UTARA,2341,5254,7595
69268,SULAWESI SELATAN,71579,LUWU,71677,BUA,4287,10712,14999
69268,SULAWESI SELATAN,71579,LUWU,71646,BUA PONRANG,2733,5233,7966
69268,SULAWESI SELATAN,71579,LUWU,71739,KAMANRE,1429,4346,5775
69268,SULAWESI SELATAN,71579,LUWU,71693,LAMASI,5601,5629,11230
69268,SULAWESI SELATAN,71579,LUWU,71785,LAMASI TIMUR,1935,4226,6161
69268,SULAWESI SELATAN,71579,LUWU,71605,LAROMPONG,2863,8972,11835
69268,SULAWESI SELATAN,71579,LUWU,71704,LAROMPONG SELATAN,1766,7184,8950
69268,SULAWESI SELATAN,71579,LUWU,71726,LATIMOJONG,957,2190,3147
69268,SULAWESI SELATAN,71579,LUWU,71715,PONRANG,4558,9108,13666
69268,SULAWESI SELATAN,71579,LUWU,71814,PONRANG SELATAN,3871,10335,14206
69268,SULAWESI SELATAN,71579,LUWU,71619,SULI,2795,7453,10248
69268,SULAWESI SELATAN,71579,LUWU,71795,SULI BARAT,830,4166,4996
69268,SULAWESI SELATAN,71579,LUWU,71657,WALENRANG,4940,8375,13315
69268,SULAWESI SELATAN,71579,LUWU,71757,WALENRANG BARAT,2824,4132,6956
69268,SULAWESI SELATAN,71579,LUWU,71776,WALENRANG TIMUR,3142,5348,8490
69268,SULAWESI SELATAN,71579,LUWU,71764,WALENRANG UTARA,4331,7626,11957
69268,SULAWESI SELATAN,72190,LUWU TIMUR,72236,ANGKONA,3714,7983,11697
69268,SULAWESI SELATAN,72190,LUWU TIMUR,72258,BURAU,4434,10803,15237
69268,SULAWESI SELATAN,72190,LUWU TIMUR,72287,KALAENA,1809,4287,6096
69268,SULAWESI SELATAN,72190,LUWU TIMUR,72220,MALILI,5040,11226,16266
69268,SULAWESI SELATAN,72190,LUWU TIMUR,72191,MANGKUTANA,3958,7090,11048
69268,SULAWESI SELATAN,72190,LUWU TIMUR,72200,NUHA,4373,5487,9860
69268,SULAWESI SELATAN,72190,LUWU TIMUR,72274,TOMONI,4609,7667,12276
69268,SULAWESI SELATAN,72190,LUWU TIMUR,72293,TOMONI TIMUR,2417,4740,7157
69268,SULAWESI SELATAN,72190,LUWU TIMUR,72206,TOWUTI,5412,8778,14190
69268,SULAWESI SELATAN,72190,LUWU TIMUR,72302,WASUPONDA,2872,5677,8549
69268,SULAWESI SELATAN,72190,LUWU TIMUR,72245,WOTU,4691,10094,14785
69268,SULAWESI SELATAN,72007,LUWU UTARA,72169,BAEBUNTA,7515,15564,23079
69268,SULAWESI SELATAN,72007,LUWU UTARA,72023,BONE BONE,4915,8083,12998
69268,SULAWESI SELATAN,72007,LUWU UTARA,72085,LIMBONG,837,771,1608
69268,SULAWESI SELATAN,72007,LUWU UTARA,72008,MALANGKE,2062,11021,13083
69268,SULAWESI SELATAN,72007,LUWU UTARA,72132,MALANGKE BARAT,2418,9047,11465
69268,SULAWESI SELATAN,72007,LUWU UTARA,72153,MAPPEDECENG,3669,8870,12539
69268,SULAWESI SELATAN,72007,LUWU UTARA,72044,MASAMBA,4654,11692,16346
69268,SULAWESI SELATAN,72007,LUWU UTARA,72146,RAMPI,468,1018,1486
69268,SULAWESI SELATAN,72007,LUWU UTARA,72064,SABBANG,6339,12082,18421
69268,SULAWESI SELATAN,72007,LUWU UTARA,72119,SEKO,3845,3126,6971
69268,SULAWESI SELATAN,72007,LUWU UTARA,72093,SUKAMAJU,10048,12952,23000
69268,SULAWESI SELATAN,72007,LUWU UTARA,83764,TANA LILI,4268,7237,11505
69268,SULAWESI SELATAN,70639,MAROS,70656,BANTIMURUNG,3748,12132,15880
69268,SULAWESI SELATAN,70639,MAROS,70673,BONTOA,2691,12089,14780
69268,SULAWESI SELATAN,70639,MAROS,70647,CAMBA,1240,6293,7533
69268,SULAWESI SELATAN,70639,MAROS,70719,CENRANA,1464,5984,7448
69268,SULAWESI SELATAN,70639,MAROS,70736,LAU,3391,10260,13651
69268,SULAWESI SELATAN,70639,MAROS,70683,MALLLAWA,1724,4939,6663
69268,SULAWESI SELATAN,70639,MAROS,70640,MANDAI,6516,12687,19203
69268,SULAWESI SELATAN,70639,MAROS,70665,MAROS BARU,2764,9847,12611
69268,SULAWESI SELATAN,70639,MAROS,70704,MARUSU,4421,10634,15055
69268,SULAWESI SELATAN,70639,MAROS,70743,MONCONG LOE,2903,6345,9248
69268,SULAWESI SELATAN,70639,MAROS,70712,SIMBANG,4057,7646,11703
69268,SULAWESI SELATAN,70639,MAROS,70695,TANRALILI,5100,6885,11985
69268,SULAWESI SELATAN,70639,MAROS,70727,TOMPOBULU,1699,4984,6683
69268,SULAWESI SELATAN,70639,MAROS,70749,TURIKALE,5473,15994,21467
69268,SULAWESI SELATAN,70757,PANGKAJENE DAN KEPULAUAN,70795,BALOCCI,2532,5889,8421
69268,SULAWESI SELATAN,70757,PANGKAJENE DAN KEPULAUAN,70801,BUNGORO,7841,13878,21719
69268,SULAWESI SELATAN,70757,PANGKAJENE DAN KEPULAUAN,70810,LABAKKANG,7813,14953,22766
69268,SULAWESI SELATAN,70757,PANGKAJENE DAN KEPULAUAN,70768,LIUKANG KALMAS,1804,4528,6332
69268,SULAWESI SELATAN,70757,PANGKAJENE DAN KEPULAUAN,70758,LIUKANG TANGAYA,2770,6494,9264
69268,SULAWESI SELATAN,70757,PANGKAJENE DAN KEPULAUAN,70776,LIUKANG TUPABBIRING,1435,7786,9221
69268,SULAWESI SELATAN,70757,PANGKAJENE DAN KEPULAUAN,70865,LIUKANG TUPABBIRING UTARA,1050,5677,6727
69268,SULAWESI SELATAN,70757,PANGKAJENE DAN KEPULAUAN,70851,MANDALLE,1811,4726,6537
69268,SULAWESI SELATAN,70757,PANGKAJENE DAN KEPULAUAN,70824,MARANG,5292,10618,15910
69268,SULAWESI SELATAN,70757,PANGKAJENE DAN KEPULAUAN,70842,MINASA TENE,5843,12337,18180
69268,SULAWESI SELATAN,70757,PANGKAJENE DAN KEPULAUAN,70785,PANGKAJENE,6350,16761,23111
69268,SULAWESI SELATAN,70757,PANGKAJENE DAN KEPULAUAN,70835,SEGERI,1824,8432,10256
69268,SULAWESI SELATAN,70757,PANGKAJENE DAN KEPULAUAN,70858,TONDONG TALLASA,1103,4119,5222
69268,SULAWESI SELATAN,71327,PINRANG,71431,BATU LAPPA,1334,3920,5254
69268,SULAWESI SELATAN,71327,PINRANG,71409,CEMPA,1855,7360,9215
69268,SULAWESI SELATAN,71327,PINRANG,71379,DUAMPANUA,4658,17165,21823
69268,SULAWESI SELATAN,71327,PINRANG,71423,LANRISANG,1900,8241,10141
69268,SULAWESI SELATAN,71327,PINRANG,71394,LEMBANG,0,0,0
69268,SULAWESI SELATAN,71327,PINRANG,71328,MATIRRO SOMPE,2730,11963,14693
69268,SULAWESI SELATAN,71327,PINRANG,71349,MATTIRO BULU,2989,12846,15835
69268,SULAWESI SELATAN,71327,PINRANG,83765,PALETEANG,5193,13124,18317
69268,SULAWESI SELATAN,71327,PINRANG,71368,PATAMPANUA,4613,11696,16309
69268,SULAWESI SELATAN,71327,PINRANG,71338,SUPPA,2587,13745,16332
69268,SULAWESI SELATAN,71327,PINRANG,71417,TIROANG,0,0,0
69268,SULAWESI SELATAN,71327,PINRANG,71359,WATANG SAWITO,6848,19833,26681
69268,SULAWESI SELATAN,71209,SIDENRENG RAPPANG,71242,BARANTI,3131,13517,16648
69268,SULAWESI SELATAN,71209,SIDENRENG RAPPANG,71290,DUA PITUE,2774,12804,15578
69268,SULAWESI SELATAN,71209,SIDENRENG RAPPANG,71261,KULO,1409,5153,6562
69268,SULAWESI SELATAN,71209,SIDENRENG RAPPANG,71268,MARITENGNGAE,4629,21492,26121
69268,SULAWESI SELATAN,71209,SIDENRENG RAPPANG,71210,PANCA LAUTANG,1099,8889,9988
69268,SULAWESI SELATAN,71209,SIDENRENG RAPPANG,71252,PANCA RIJANG,3708,12151,15859
69268,SULAWESI SELATAN,71209,SIDENRENG RAPPANG,71314,PITU RIASE,2212,9239,11451
69268,SULAWESI SELATAN,71209,SIDENRENG RAPPANG,71301,PITU RIAWA,2923,11684,14607
69268,SULAWESI SELATAN,71209,SIDENRENG RAPPANG,71221,TELLU LIMPOE,3115,10380,13495
69268,SULAWESI SELATAN,71209,SIDENRENG RAPPANG,71231,WATANG PULU,4310,12557,16867
69268,SULAWESI SELATAN,70149,SINJAI,70205,BULUPODDO,3230,5534,8764
69268,SULAWESI SELATAN,70149,SINJAI,70234,PULAU SEMBILAN,948,2321,3269
69268,SULAWESI SELATAN,70149,SINJAI,70160,SINJAI  SELATAN,6443,12670,19113
69268,SULAWESI SELATAN,70149,SINJAI,70150,SINJAI BARAT,4560,6997,11557
69268,SULAWESI SELATAN,70149,SINJAI,70213,SINJAI BORONG,3019,4694,7713
69268,SULAWESI SELATAN,70149,SINJAI,70186,SINJAI TENGAH,4967,8662,13629
69268,SULAWESI SELATAN,70149,SINJAI,70172,SINJAI TIMUR,4904,9715,14619
69268,SULAWESI SELATAN,70149,SINJAI,70198,SINJAI UTARA,8055,13050,21105
69268,SULAWESI SELATAN,70149,SINJAI,70222,TELLU LIMPOE,5916,10632,16548
69268,SULAWESI SELATAN,70935,SOPPENG,71009,CITTA,974,3268,4242
69268,SULAWESI SELATAN,70935,SOPPENG,70994,DONRI DONRI,1489,12046,13535
69268,SULAWESI SELATAN,70935,SOPPENG,71004,GANRA,1076,5729,6805
69268,SULAWESI SELATAN,70935,SOPPENG,70972,LALABATA,4379,21783,26162
69268,SULAWESI SELATAN,70935,SOPPENG,70950,LILIRIAJA,2374,12899,15273
69268,SULAWESI SELATAN,70935,SOPPENG,70959,LILIRILAU,3447,18838,22285
69268,SULAWESI SELATAN,70935,SOPPENG,70983,MARIORIAWA,2137,14539,16676
69268,SULAWESI SELATAN,70935,SOPPENG,70936,MARIORIWAWO,3769,20457,24226
69268,SULAWESI SELATAN,69869,TAKALAR,69949,GALESONG,5914,13578,19492
69268,SULAWESI SELATAN,69869,TAKALAR,69915,GALESONG SELATAN,4320,9026,13346
69268,SULAWESI SELATAN,69869,TAKALAR,69925,GALESONG UTARA,6253,14474,20727
69268,SULAWESI SELATAN,69869,TAKALAR,69877,MANGARABOMBANG,6477,12530,19007
69268,SULAWESI SELATAN,69869,TAKALAR,69870,MAPPAKASUNGGU,1840,6141,7981
69268,SULAWESI SELATAN,69869,TAKALAR,69934,PATTALLASSANG,7362,11921,19283
69268,SULAWESI SELATAN,69869,TAKALAR,69890,POLOMBANGKENG SELATAN,5404,10273,15677
69268,SULAWESI SELATAN,69869,TAKALAR,69899,POLOMBANGKENG UTARA,11400,15637,27037
69268,SULAWESI SELATAN,69869,TAKALAR,69943,SANROBONE,2328,4896,7224
69268,SULAWESI SELATAN,71828,TANA TORAJA,71839,BITTUANG,1579,4535,6114
69268,SULAWESI SELATAN,71828,TANA TORAJA,71855,BONGGAKARADENG,984,1841,2825
69268,SULAWESI SELATAN,71828,TANA TORAJA,71916,GANDANGBATU SILLANAN,2542,6997,9539
69268,SULAWESI SELATAN,71828,TANA TORAJA,72000,KURRA,515,1832,2347
69268,SULAWESI SELATAN,71828,TANA TORAJA,71862,MAKALE,5060,11447,16507
69268,SULAWESI SELATAN,71828,TANA TORAJA,71956,MAKALE SELATAN,1914,3586,5500
69268,SULAWESI SELATAN,71828,TANA TORAJA,71943,MAKALE UTARA,1619,4830,6449
69268,SULAWESI SELATAN,71828,TANA TORAJA,71987,MALIMBONG BALEPE,870,2781,3651
69268,SULAWESI SELATAN,71828,TANA TORAJA,71949,MAPPAK,749,2338,3087
69268,SULAWESI SELATAN,71828,TANA TORAJA,71965,MASANDA,726,1800,2526
69268,SULAWESI SELATAN,71828,TANA TORAJA,71892,MENGKENDEK,4374,9952,14326
69268,SULAWESI SELATAN,71828,TANA TORAJA,71994,RANO,995,1648,2643
69268,SULAWESI SELATAN,71828,TANA TORAJA,71885,RANTETAYO,1495,4148,5643
69268,SULAWESI SELATAN,71828,TANA TORAJA,71929,REMBON,2599,6051,8650
69268,SULAWESI SELATAN,71828,TANA TORAJA,71829,SALUPUTI,1072,2673,3745
69268,SULAWESI SELATAN,71828,TANA TORAJA,71910,SANGALLA,1041,2542,3583
69268,SULAWESI SELATAN,71828,TANA TORAJA,71974,SANGALLA SELATAN,977,2786,3763
69268,SULAWESI SELATAN,71828,TANA TORAJA,71980,SANGALLA UTARA,983,3004,3987
69268,SULAWESI SELATAN,71828,TANA TORAJA,71878,SIMBUANG,1122,1841,2963
69268,SULAWESI SELATAN,69269,TORAJA UTARA,69437,AWAN RANTE KARUA,620,1601,2221
69268,SULAWESI SELATAN,69269,TORAJA UTARA,69354,BALUSU,1470,3459,4929
69268,SULAWESI SELATAN,69269,TORAJA UTARA,69379,BUNTU PEPASAN,2170,6947,9117
69268,SULAWESI SELATAN,69269,TORAJA UTARA,69430,KAPALA PITU,795,1823,2618
69268,SULAWESI SELATAN,69269,TORAJA UTARA,69292,NANGGALA,2019,3641,5660
69268,SULAWESI SELATAN,69269,TORAJA UTARA,69416,RANTEBUA,1891,4844,6735
69268,SULAWESI SELATAN,69269,TORAJA UTARA,69270,RANTEPAO,3787,8020,11807
69268,SULAWESI SELATAN,69269,TORAJA UTARA,69302,RINDINGALLO,952,3099,4051
69268,SULAWESI SELATAN,69269,TORAJA UTARA,69330,SANGGALANGI,2051,3824,5875
69268,SULAWESI SELATAN,69269,TORAJA UTARA,69282,SESEAN,1714,3999,5713
69268,SULAWESI SELATAN,69269,TORAJA UTARA,69424,SESEAN SULOARA,963,2682,3645
69268,SULAWESI SELATAN,69269,TORAJA UTARA,69337,SOPAI,2535,4009,6544
69268,SULAWESI SELATAN,69269,TORAJA UTARA,69362,TALLUNGLIPU,2886,6013,8899
69268,SULAWESI SELATAN,69269,TORAJA UTARA,69346,TIKALA,1613,3325,4938
69268,SULAWESI SELATAN,69269,TORAJA UTARA,69406,TONDON,2792,3844,6636
69268,SULAWESI SELATAN,71014,WAJO,71107,BELAWA,0,0,0
69268,SULAWESI SELATAN,71014,WAJO,71162,BOLA,0,0,0
69268,SULAWESI SELATAN,71014,WAJO,71187,GILIRENG,0,0,0
69268,SULAWESI SELATAN,71014,WAJO,71198,KEERA,0,0,0
69268,SULAWESI SELATAN,71014,WAJO,71071,MAJAULENG,0,0,0
69268,SULAWESI SELATAN,71014,WAJO,71138,MANIANGPAJO,0,0,0
69268,SULAWESI SELATAN,71014,WAJO,71031,PAMMANA,0,0,0
69268,SULAWESI SELATAN,71014,WAJO,71175,PENRANG,0,0,0
69268,SULAWESI SELATAN,71014,WAJO,71147,PITUMPANUA,0,0,0
69268,SULAWESI SELATAN,71014,WAJO,71015,SABANGPARU,0,0,0
69268,SULAWESI SELATAN,71014,WAJO,71061,SAJOANGING,0,0,0
69268,SULAWESI SELATAN,71014,WAJO,71047,TAKKALALLA,0,0,0
69268,SULAWESI SELATAN,71014,WAJO,71118,TANASITOLO,0,0,0
69268,SULAWESI SELATAN,71014,WAJO,71090,TEMPE,0,0,0
67393,SULAWESI TENGAH,67558,BANGGAI,67650,BALANTAK,994,1976,2970
67393,SULAWESI TENGAH,67558,BANGGAI,67854,BALANTAK SELATAN,927,1666,2593
67393,SULAWESI TENGAH,67558,BANGGAI,83794,BALANTAK UTARA,977,1198,2175
67393,SULAWESI TENGAH,67558,BANGGAI,67559,BATUI,3211,5383,8594
67393,SULAWESI TENGAH,67558,BANGGAI,67820,BATUI SELATAN,2206,5029,7235
67393,SULAWESI TENGAH,67558,BANGGAI,67702,BUALEMO,4768,4657,9425
67393,SULAWESI TENGAH,67558,BANGGAI,67573,BUNTA,3780,5760,9540
67393,SULAWESI TENGAH,67558,BANGGAI,67593,KINTOM,2851,2988,5839
67393,SULAWESI TENGAH,67558,BANGGAI,67630,LAMALA,1348,2169,3517
67393,SULAWESI TENGAH,67558,BANGGAI,67831,LOBU,831,1140,1971
67393,SULAWESI TENGAH,67558,BANGGAI,67608,LUWUK,8336,8283,16619
67393,SULAWESI TENGAH,67558,BANGGAI,83795,LUWUK SELATAN,6049,4642,10691
67393,SULAWESI TENGAH,67558,BANGGAI,67754,LUWUK TIMUR,2897,3074,5971
67393,SULAWESI TENGAH,67558,BANGGAI,83796,LUWUK UTARA,4198,4145,8343
67393,SULAWESI TENGAH,67558,BANGGAI,83797,MANTOH,1062,2456,3518
67393,SULAWESI TENGAH,67558,BANGGAI,67742,MASAMA,2108,4426,6534
67393,SULAWESI TENGAH,67558,BANGGAI,67803,MOILONG,4040,5870,9910
67393,SULAWESI TENGAH,67558,BANGGAI,83798,NAMBO,2615,2102,4717
67393,SULAWESI TENGAH,67558,BANGGAI,67784,NUHON,3357,5721,9078
67393,SULAWESI TENGAH,67558,BANGGAI,67669,PAGIMANA,6135,6068,12203
67393,SULAWESI TENGAH,67558,BANGGAI,67841,SIMPANG RAYA,2113,5189,7302
67393,SULAWESI TENGAH,67558,BANGGAI,67719,TOILI,6297,11298,17595
67393,SULAWESI TENGAH,67558,BANGGAI,67767,TOILI BARAT,3782,8036,11818
67393,SULAWESI TENGAH,68681,BANGGAI KEPULAUAN,68690,BANGGAI,0,0,0
67393,SULAWESI TENGAH,68681,BANGGAI KEPULAUAN,68834,BANGGAI SELATAN,0,0,0
67393,SULAWESI TENGAH,68681,BANGGAI KEPULAUAN,68827,BANGGAI TENGAH,0,0,0
67393,SULAWESI TENGAH,68681,BANGGAI KEPULAUAN,68799,BANGGAI UTARA,0,0,0
67393,SULAWESI TENGAH,68681,BANGGAI KEPULAUAN,68816,BANGKURUNG,0,0,0
67393,SULAWESI TENGAH,68681,BANGGAI KEPULAUAN,68768,BOKAN KEPULAUAN,0,0,0
67393,SULAWESI TENGAH,68681,BANGGAI KEPULAUAN,68757,BUKO,0,0,0
67393,SULAWESI TENGAH,68681,BANGGAI KEPULAUAN,68872,BUKO SELATAN,0,0,0
67393,SULAWESI TENGAH,68681,BANGGAI KEPULAUAN,68741,BULAGI,0,0,0
67393,SULAWESI TENGAH,68681,BANGGAI KEPULAUAN,68784,BULAGI SELATAN,0,0,0
67393,SULAWESI TENGAH,68681,BANGGAI KEPULAUAN,68860,BULAGI UTARA,0,0,0
67393,SULAWESI TENGAH,68681,BANGGAI KEPULAUAN,68682,LABOBO,0,0,0
67393,SULAWESI TENGAH,68681,BANGGAI KEPULAUAN,68725,LIANG,0,0,0
67393,SULAWESI TENGAH,68681,BANGGAI KEPULAUAN,68848,PELING TENGAH,0,0,0
67393,SULAWESI TENGAH,68681,BANGGAI KEPULAUAN,68713,TINANGKUNG,0,0,0
67393,SULAWESI TENGAH,68681,BANGGAI KEPULAUAN,68806,TINANGKUNG SELATAN,0,0,0
67393,SULAWESI TENGAH,68681,BANGGAI KEPULAUAN,68881,TINANGKUNG UTARA,0,0,0
67393,SULAWESI TENGAH,68681,BANGGAI KEPULAUAN,68701,TOTIKUM,0,0,0
67393,SULAWESI TENGAH,68681,BANGGAI KEPULAUAN,68840,TOTIKUM SELATAN,0,0,0
67393,SULAWESI TENGAH,68309,BUOL,68414,BIAU,6794,6129,12923
67393,SULAWESI TENGAH,68309,BUOL,68326,BOKAT,3384,3448,6832
67393,SULAWESI TENGAH,68309,BUOL,68374,BUKAL,2734,4507,7241
67393,SULAWESI TENGAH,68309,BUOL,68342,BUNOBOGU,2210,2292,4502
67393,SULAWESI TENGAH,68309,BUOL,68387,GADUNG,2652,2612,5264
67393,SULAWESI TENGAH,68309,BUOL,68398,KARAMAT,2088,2366,4454
67393,SULAWESI TENGAH,68309,BUOL,68422,LAKEA,1987,2815,4802
67393,SULAWESI TENGAH,68309,BUOL,68310,MOMUNU,3509,3807,7316
67393,SULAWESI TENGAH,68309,BUOL,68351,PALELEH,3232,2863,6095
67393,SULAWESI TENGAH,68309,BUOL,68406,PALELEH BARAT,1414,1613,3027
67393,SULAWESI TENGAH,68309,BUOL,68364,TILOAN,2198,2887,5085
67393,SULAWESI TENGAH,68041,DONGGALA,68119,BALAESANG,4402,6222,10624
67393,SULAWESI TENGAH,68041,DONGGALA,68197,BALAESANG TANJUNG,2057,3228,5285
67393,SULAWESI TENGAH,68041,DONGGALA,68070,BANAWA,8770,7968,16738
67393,SULAWESI TENGAH,68041,DONGGALA,68140,BANAWA SELATAN,4895,6430,11325
67393,SULAWESI TENGAH,68041,DONGGALA,68184,BANAWA TENGAH,3514,1943,5457
67393,SULAWESI TENGAH,68041,DONGGALA,68057,DOMPELAS SOJOL,5332,9500,14832
67393,SULAWESI TENGAH,68041,DONGGALA,68085,LABUAN,3625,3340,6965
67393,SULAWESI TENGAH,68041,DONGGALA,68165,PANEMBANI,1966,1644,3610
67393,SULAWESI TENGAH,68041,DONGGALA,68042,RIO PAKAVA,3096,6738,9834
67393,SULAWESI TENGAH,68041,DONGGALA,68092,SINDUE,6339,3985,10324
67393,SULAWESI TENGAH,68041,DONGGALA,68178,SINDUE TOBATA,1468,2834,4302
67393,SULAWESI TENGAH,68041,DONGGALA,68172,SINDUE TOMBUSABORA,2319,2904,5223
67393,SULAWESI TENGAH,68041,DONGGALA,68106,SIRENJA,3594,6270,9864
67393,SULAWESI TENGAH,68041,DONGGALA,68130,SOJOL,2447,8855,11302
67393,SULAWESI TENGAH,68041,DONGGALA,68192,SOJOL UTARA,892,3644,4536
67393,SULAWESI TENGAH,68041,DONGGALA,68156,TANANTOVEA,4413,4116,8529
67393,SULAWESI TENGAH,69220,KOTA PALU,83810,MANTIKULORE,17397,14280,31677
67393,SULAWESI TENGAH,69220,KOTA PALU,69230,PALU BARAT,11274,13643,24917
67393,SULAWESI TENGAH,69220,KOTA PALU,69246,PALU SELATAN,16249,16945,33194
67393,SULAWESI TENGAH,69220,KOTA PALU,69221,PALU TIMUR,12434,11883,24317
67393,SULAWESI TENGAH,69220,KOTA PALU,69259,PALU UTARA,5622,5009,10631
67393,SULAWESI TENGAH,69220,KOTA PALU,83808,TATANGA,12550,9089,21639
67393,SULAWESI TENGAH,69220,KOTA PALU,83809,TAWAELI,5714,5013,10727
67393,SULAWESI TENGAH,69220,KOTA PALU,83807,ULUJADI,9504,5899,15403
67393,SULAWESI TENGAH,68428,MOROWALI,68633,BAHODOPI,0,0,0
67393,SULAWESI TENGAH,68428,MOROWALI,68619,BUMI RAYA,0,0,0
67393,SULAWESI TENGAH,68428,MOROWALI,68608,BUNGKU BARAT,0,0,0
67393,SULAWESI TENGAH,68428,MOROWALI,83802,BUNGKU PESISIR,0,0,0
67393,SULAWESI TENGAH,68428,MOROWALI,68555,BUNGKU SELATAN,0,0,0
67393,SULAWESI TENGAH,68428,MOROWALI,68525,BUNGKU TENGAH,0,0,0
67393,SULAWESI TENGAH,68428,MOROWALI,83805,BUNGKU TIMUR,0,0,0
67393,SULAWESI TENGAH,68428,MOROWALI,68504,BUNGKU UTARA,0,0,0
67393,SULAWESI TENGAH,68428,MOROWALI,68450,LEMBO,0,0,0
67393,SULAWESI TENGAH,68428,MOROWALI,83803,LEMBO RAYA,0,0,0
67393,SULAWESI TENGAH,68428,MOROWALI,68666,MAMOSALATO,0,0,0
67393,SULAWESI TENGAH,68428,MOROWALI,68589,MENUI KEPULAUAN,0,0,0
67393,SULAWESI TENGAH,68428,MOROWALI,83801,MORI UTARA,0,0,0
67393,SULAWESI TENGAH,68428,MOROWALI,68429,MORIS ATAS,0,0,0
67393,SULAWESI TENGAH,68428,MOROWALI,68475,PETASIA,0,0,0
67393,SULAWESI TENGAH,68428,MOROWALI,83806,PETASIA BARAT,0,0,0
67393,SULAWESI TENGAH,68428,MOROWALI,83804,PETASIA TIMUR,0,0,0
67393,SULAWESI TENGAH,68428,MOROWALI,68646,SOYO JAYA,0,0,0
67393,SULAWESI TENGAH,68428,MOROWALI,68656,WITA PONDA,0,0,0
67393,SULAWESI TENGAH,68887,PARIGI MOUTONG,68899,AMPIBABO,5360,5245,10605
67393,SULAWESI TENGAH,68887,PARIGI MOUTONG,69047,BALINGGI,4046,5640,9686
67393,SULAWESI TENGAH,68887,PARIGI MOUTONG,89758,BOLANO,4159,4182,8341
67393,SULAWESI TENGAH,68887,PARIGI MOUTONG,68957,BOLANO LAMBUNU,4409,6417,10826
67393,SULAWESI TENGAH,68887,PARIGI MOUTONG,68980,KASIMBAR,4154,6826,10980
67393,SULAWESI TENGAH,68887,PARIGI MOUTONG,69020,MEPANGA,6782,7486,14268
67393,SULAWESI TENGAH,68887,PARIGI MOUTONG,68926,MOUTONG,4963,5606,10569
67393,SULAWESI TENGAH,68887,PARIGI MOUTONG,89765,ONGKA MALINO,4692,5307,9999
67393,SULAWESI TENGAH,68887,PARIGI MOUTONG,69067,PALASA,4965,6917,11882
67393,SULAWESI TENGAH,68887,PARIGI MOUTONG,68888,PARIGI,5326,8578,13904
67393,SULAWESI TENGAH,68887,PARIGI MOUTONG,69054,PARIGI BARAT,1979,1950,3929
67393,SULAWESI TENGAH,68887,PARIGI MOUTONG,69011,PARIGI SELATAN,3900,7377,11277
67393,SULAWESI TENGAH,68887,PARIGI MOUTONG,69082,PARIGI TENGAH,2295,2003,4298
67393,SULAWESI TENGAH,68887,PARIGI MOUTONG,69076,PARIGI UTARA,2071,1137,3208
67393,SULAWESI TENGAH,68887,PARIGI MOUTONG,68948,SAUSU,4229,6868,11097
67393,SULAWESI TENGAH,68887,PARIGI MOUTONG,69060,SINIU,2721,2241,4962
67393,SULAWESI TENGAH,68887,PARIGI MOUTONG,69039,TAOPA,3065,3621,6686
67393,SULAWESI TENGAH,68887,PARIGI MOUTONG,68911,TINOMBO,7819,8262,16081
67393,SULAWESI TENGAH,68887,PARIGI MOUTONG,68996,TINOMBO SELATAN,5464,6925,12389
67393,SULAWESI TENGAH,68887,PARIGI MOUTONG,68938,TOMINI,4855,3806,8661
67393,SULAWESI TENGAH,68887,PARIGI MOUTONG,69031,TORIBULU,2986,5023,8009
67393,SULAWESI TENGAH,68887,PARIGI MOUTONG,68989,TORUE,3278,6913,10191
67393,SULAWESI TENGAH,67866,POSO,67887,LAGE,4840,5829,10669
67393,SULAWESI TENGAH,67866,POSO,68013,LORE BARAT,861,914,1775
67393,SULAWESI TENGAH,67866,POSO,68025,LORE PIORE,1005,991,1996
67393,SULAWESI TENGAH,67866,POSO,67966,LORE SELATAN,1903,1630,3533
67393,SULAWESI TENGAH,67866,POSO,67957,LORE TENGAH,1442,1001,2443
67393,SULAWESI TENGAH,67866,POSO,68020,LORE TIMUR,1027,1880,2907
67393,SULAWESI TENGAH,67866,POSO,67949,LORE UTARA,2918,3114,6032
67393,SULAWESI TENGAH,67866,POSO,67994,PAMONA BARAT,1656,3432,5088
67393,SULAWESI TENGAH,67866,POSO,83799,PAMONA PUSELEMBA,3703,7022,10725
67393,SULAWESI TENGAH,67866,POSO,67936,PAMONA SELATAN,4603,5603,10206
67393,SULAWESI TENGAH,67866,POSO,68031,PAMONA TENGGARA,1739,2196,3935
67393,SULAWESI TENGAH,67866,POSO,67923,PAMONA TIMUR,2504,3762,6266
67393,SULAWESI TENGAH,67866,POSO,67902,PAMONA UTARA,2309,5575,7884
67393,SULAWESI TENGAH,67866,POSO,67867,POSO KOTA,5639,4119,9758
67393,SULAWESI TENGAH,67866,POSO,68000,POSO KOTA SELATAN,2442,2337,4779
67393,SULAWESI TENGAH,67866,POSO,68006,POSO KOTA UTARA,3460,2365,5825
67393,SULAWESI TENGAH,67866,POSO,67872,POSO PESISIR,4934,4908,9842
67393,SULAWESI TENGAH,67866,POSO,67985,POSO PESISIR SELATAN,2954,2473,5427
67393,SULAWESI TENGAH,67866,POSO,67975,POSO PESISIR UTARA,3212,4812,8024
67393,SULAWESI TENGAH,67394,SIGI,67515,DOLO,8345,3524,11869
67393,SULAWESI TENGAH,67394,SIGI,67504,DOLO BARAT,5141,2050,7191
67393,SULAWESI TENGAH,67394,SIGI,67487,DOLO SELATAN,5592,1939,7531
67393,SULAWESI TENGAH,67394,SIGI,67480,GUMBASA,3969,2836,6805
67393,SULAWESI TENGAH,67394,SIGI,67527,KINOVARO,4045,2029,6074
67393,SULAWESI TENGAH,67394,SIGI,67444,KULAWI,4279,3984,8263
67393,SULAWESI TENGAH,67394,SIGI,67457,KULAWI SELATAN,1922,2758,4680
67393,SULAWESI TENGAH,67394,SIGI,67439,LINDU,1171,1620,2791
67393,SULAWESI TENGAH,67394,SIGI,67536,MARAWOLA,8318,3991,12309
67393,SULAWESI TENGAH,67394,SIGI,67547,MARAWOLA BARAT,1710,2688,4398
67393,SULAWESI TENGAH,67394,SIGI,67433,NOKILALAKI,1285,1535,2820
67393,SULAWESI TENGAH,67394,SIGI,67413,PALOLO,6774,8908,15682
67393,SULAWESI TENGAH,67394,SIGI,67468,PIPIKORO,2480,2625,5105
67393,SULAWESI TENGAH,67394,SIGI,67395,SIGI BIROMARU,15899,8366,24265
67393,SULAWESI TENGAH,67394,SIGI,67499,TANAMBULAVA,2875,1710,4585
67393,SULAWESI TENGAH,68206,TOLITOLI,68268,BAOLAN,13482,16963,30445
67393,SULAWESI TENGAH,68206,TOLITOLI,68239,BASIDONDO,1293,3714,5007
67393,SULAWESI TENGAH,68206,TOLITOLI,68304,DAKO PEMEAN,1933,2672,4605
67393,SULAWESI TENGAH,68206,TOLITOLI,68207,DAMPAL SELATAN,1504,9285,10789
67393,SULAWESI TENGAH,68206,TOLITOLI,68217,DAMPAL UTARA,2217,3988,6205
67393,SULAWESI TENGAH,68206,TOLITOLI,68226,DONDO,3103,7446,10549
67393,SULAWESI TENGAH,68206,TOLITOLI,68282,GALANG,5591,10835,16426
67393,SULAWESI TENGAH,68206,TOLITOLI,68259,LAMPASIO,1585,4508,6093
67393,SULAWESI TENGAH,68206,TOLITOLI,68247,OGODEIDE,1859,4234,6093
72551,SULAWESI TENGGARA,74018,BOMBANA,74051,KABAENA,868,595,1463
72551,SULAWESI TENGGARA,74018,BOMBANA,74119,KABAENA BARAT,1236,2082,3318
72551,SULAWESI TENGGARA,74018,BOMBANA,74114,KABAENA SELATAN,1084,552,1636
72551,SULAWESI TENGGARA,74018,BOMBANA,74132,KABAENA TENGAH,1074,617,1691
72551,SULAWESI TENGGARA,74018,BOMBANA,74056,KABAENA TIMUR,1180,1821,3001
72551,SULAWESI TENGGARA,74018,BOMBANA,74125,KABAENA UTARA,760,938,1698
72551,SULAWESI TENGGARA,74018,BOMBANA,74163,LANTARI JAYA,1696,2223,3919
72551,SULAWESI TENGGARA,74018,BOMBANA,74074,MATA OLEO,1537,1406,2943
72551,SULAWESI TENGGARA,74018,BOMBANA,74173,MATA USU,282,551,833
72551,SULAWESI TENGGARA,74018,BOMBANA,74019,POLEANG,2231,4996,7227
72551,SULAWESI TENGGARA,74018,BOMBANA,74064,POLEANG BARAT,1927,3664,5591
72551,SULAWESI TENGGARA,74018,BOMBANA,74103,POLEANG SELATAN,576,2478,3054
72551,SULAWESI TENGGARA,74018,BOMBANA,74152,POLEANG TENGAH,458,1351,1809
72551,SULAWESI TENGGARA,74018,BOMBANA,74109,POLEANG TENGGARA,514,1190,1704
72551,SULAWESI TENGGARA,74018,BOMBANA,74030,POLEANG TIMUR,1125,3385,4510
72551,SULAWESI TENGGARA,74018,BOMBANA,74094,POLEANG UTARA,0,0,0
72551,SULAWESI TENGGARA,74018,BOMBANA,74036,RAROWATU,1281,1257,2538
72551,SULAWESI TENGGARA,74018,BOMBANA,74085,RAROWATU UTARA,1389,2080,3469
72551,SULAWESI TENGGARA,74018,BOMBANA,74045,RUMBIA,1925,2635,4560
72551,SULAWESI TENGGARA,74018,BOMBANA,74146,RUMBIA TENGAH,1006,1806,2812
72551,SULAWESI TENGGARA,74018,BOMBANA,74157,TONTONUNU,689,1808,2497
72551,SULAWESI TENGGARA,73420,BUTON,73474,BATAUGA,2571,4325,6896
72551,SULAWESI TENGGARA,73420,BUTON,73546,BATU ATAS,676,2216,2892
72551,SULAWESI TENGGARA,73420,BUTON,73463,G U,7341,2910,10251
72551,SULAWESI TENGGARA,73420,BUTON,73526,KADATUA,2112,1476,3588
72551,SULAWESI TENGGARA,73420,BUTON,73554,KAPONTORI,3403,3607,7010
72551,SULAWESI TENGGARA,73420,BUTON,73448,LAKUDO,5643,4534,10177
72551,SULAWESI TENGGARA,73420,BUTON,73621,LAPANDEWA,1560,1671,3231
72551,SULAWESI TENGGARA,73420,BUTON,73571,LASALIMU,1716,3419,5135
72551,SULAWESI TENGGARA,73420,BUTON,73583,LASALIMU SELATAN,2498,2962,5460
72551,SULAWESI TENGGARA,73420,BUTON,73421,MAWASANGKA,4526,5360,9886
72551,SULAWESI TENGGARA,73420,BUTON,73597,MAWASANGKA TENGAH,2077,1871,3948
72551,SULAWESI TENGGARA,73420,BUTON,73439,MAWASANGKA TIMUR,1540,875,2415
72551,SULAWESI TENGGARA,73420,BUTON,73498,PASARWAJO,5645,12815,18460
72551,SULAWESI TENGGARA,73420,BUTON,73485,SAMPOLAWA,2916,6423,9339
72551,SULAWESI TENGGARA,73420,BUTON,73614,SANGIA WAMBULU,2598,892,3490
72551,SULAWESI TENGGARA,73420,BUTON,73537,SIOMPU,1511,2503,4014
72551,SULAWESI TENGGARA,73420,BUTON,73607,SIOMPU BARAT,1925,1034,2959
72551,SULAWESI TENGGARA,73420,BUTON,73640,SIOTAPINA,1709,3989,5698
72551,SULAWESI TENGGARA,73420,BUTON,73519,TELAGA RAYA,1120,2896,4016
72551,SULAWESI TENGGARA,73420,BUTON,73628,WABULA,951,1722,2673
72551,SULAWESI TENGGARA,73420,BUTON,73634,WOLOWA,755,1667,2422
72551,SULAWESI TENGGARA,74525,BUTON UTARA,74550,BONEGUNU,1307,2386,3693
72551,SULAWESI TENGGARA,74525,BUTON UTARA,74541,KAMBOWA,994,2062,3056
72551,SULAWESI TENGGARA,74525,BUTON UTARA,74526,KULISUSU,4343,6871,11214
72551,SULAWESI TENGGARA,74525,BUTON UTARA,74561,KULISUSU BARAT,1140,1829,2969
72551,SULAWESI TENGGARA,74525,BUTON UTARA,74571,KULISUSU UTARA,1765,2416,4181
72551,SULAWESI TENGGARA,74525,BUTON UTARA,74581,WAKORUMBA UTARA,1459,1575,3034
72551,SULAWESI TENGGARA,72552,KOLAKA,72656,BAULA,2665,2427,5092
72551,SULAWESI TENGGARA,72552,KOLAKA,72588,KOLAKA,9152,8372,17524
72551,SULAWESI TENGGARA,72552,KOLAKA,72622,LADONGI,4375,8020,12395
72551,SULAWESI TENGGARA,72552,KOLAKA,72757,LALOLAE,976,723,1699
72551,SULAWESI TENGGARA,72552,KOLAKA,72702,LAMBANDIA,2298,11517,13815
72551,SULAWESI TENGGARA,72552,KOLAKA,72680,LATAMBAGA,5256,7933,13189
72551,SULAWESI TENGGARA,72552,KOLAKA,72777,LOEA,1352,2115,3467
72551,SULAWESI TENGGARA,72552,KOLAKA,72579,MOWEWE,2756,1322,4078
72551,SULAWESI TENGGARA,72552,KOLAKA,72770,POLINGGONA,935,1821,2756
72551,SULAWESI TENGGARA,72552,KOLAKA,72596,POMALAA,5687,7541,13228
72551,SULAWESI TENGGARA,72552,KOLAKA,72723,SAMATURU,3515,6943,10458
72551,SULAWESI TENGGARA,72552,KOLAKA,72688,TANGGETADA,2143,4552,6695
72551,SULAWESI TENGGARA,72552,KOLAKA,72739,TINONDO,1534,1954,3488
72551,SULAWESI TENGGARA,72552,KOLAKA,72565,TIRAWUTA,3289,3320,6609
72551,SULAWESI TENGGARA,72552,KOLAKA,72763,TOARI,1858,2553,4411
72551,SULAWESI TENGGARA,72552,KOLAKA,72666,ULUIWOI,2552,1296,3848
72551,SULAWESI TENGGARA,72552,KOLAKA,72609,WATUBANGGA,2195,5230,7425
72551,SULAWESI TENGGARA,72552,KOLAKA,72636,WOLO,4288,7258,11546
72551,SULAWESI TENGGARA,72552,KOLAKA,72553,WUNDULAKO,6069,3864,9933
72551,SULAWESI TENGGARA,74288,KOLAKA UTARA,74314,BATU PUTIH,1260,3012,4272
72551,SULAWESI TENGGARA,74288,KOLAKA UTARA,74415,KATOI,711,2519,3230
72551,SULAWESI TENGGARA,74288,KOLAKA UTARA,74334,KODEOHA,1023,4434,5457
72551,SULAWESI TENGGARA,74288,KOLAKA UTARA,74368,LAMBAI,590,2670,3260
72551,SULAWESI TENGGARA,74288,KOLAKA UTARA,74289,LASUSUA,3020,8644,11664
72551,SULAWESI TENGGARA,74288,KOLAKA UTARA,74347,NGAPA,1919,9334,11253
72551,SULAWESI TENGGARA,74288,KOLAKA UTARA,74302,PAKUE,1124,3784,4908
72551,SULAWESI TENGGARA,74288,KOLAKA UTARA,74385,PAKUE TENGAH,895,3104,3999
72551,SULAWESI TENGGARA,74288,KOLAKA UTARA,74396,PAKUE UTARA,927,3044,3971
72551,SULAWESI TENGGARA,74288,KOLAKA UTARA,74406,POREHU,931,2339,3270
72551,SULAWESI TENGGARA,74288,KOLAKA UTARA,74326,RANTE ANGIN,653,2181,2834
72551,SULAWESI TENGGARA,74288,KOLAKA UTARA,74422,TIWU,540,1909,2449
72551,SULAWESI TENGGARA,74288,KOLAKA UTARA,74430,TOLALA,271,1212,1483
72551,SULAWESI TENGGARA,74288,KOLAKA UTARA,74376,WATUNOHU,499,3560,4059
72551,SULAWESI TENGGARA,74288,KOLAKA UTARA,74360,WAWO,1031,2282,3313
72551,SULAWESI TENGGARA,72786,KONAWE,72880,ABUKI,3698,4018,7716
72551,SULAWESI TENGGARA,72786,KONAWE,73061,AMONGGEDO,2861,2967,5828
72551,SULAWESI TENGGARA,72786,KONAWE,73046,ANGGABERI,2966,997,3963
72551,SULAWESI TENGGARA,72786,KONAWE,73083,ASINUA,629,775,1404
72551,SULAWESI TENGGARA,72786,KONAWE,73010,BESULUTU,2131,1615,3746
72551,SULAWESI TENGGARA,72786,KONAWE,73023,BONDOALA,3001,1547,4548
72551,SULAWESI TENGGARA,72786,KONAWE,73099,KAPOIALA,1301,1072,2373
72551,SULAWESI TENGGARA,72786,KONAWE,73089,KONAWE,2855,1439,4294
72551,SULAWESI TENGGARA,72786,KONAWE,73130,LALONGGASUMEETO,1823,945,2768
72551,SULAWESI TENGGARA,72786,KONAWE,72787,LAMBUYA,2059,1421,3480
72551,SULAWESI TENGGARA,72786,KONAWE,72944,LATOMA,735,390,1125
72551,SULAWESI TENGGARA,72786,KONAWE,73052,MELUHU,1340,1460,2800
72551,SULAWESI TENGGARA,72786,KONAWE,73141,ONEMBUTE,1772,1676,3448
72551,SULAWESI TENGGARA,72786,KONAWE,72827,PONDIDAHA,3623,2123,5746
72551,SULAWESI TENGGARA,72786,KONAWE,72955,PURIALA,2830,1408,4238
72551,SULAWESI TENGGARA,72786,KONAWE,73039,ROUTA,277,1540,1817
72551,SULAWESI TENGGARA,72786,KONAWE,72843,SAMPARA,5154,1800,6954
72551,SULAWESI TENGGARA,72786,KONAWE,72897,SOROPIA,2641,1853,4494
72551,SULAWESI TENGGARA,72786,KONAWE,72926,TONGAUNA,4971,3946,8917
72551,SULAWESI TENGGARA,72786,KONAWE,72968,UEPAI,3743,2935,6678
72551,SULAWESI TENGGARA,72786,KONAWE,72797,UNAAHA,6490,5220,11710
72551,SULAWESI TENGGARA,72786,KONAWE,72865,WAWONII BARAT,1576,1681,3257
72551,SULAWESI TENGGARA,72786,KONAWE,72909,WAWONII SELATAN,1483,841,2324
72551,SULAWESI TENGGARA,72786,KONAWE,73075,WAWONII TENGAH,558,913,1471
72551,SULAWESI TENGGARA,72786,KONAWE,73110,WAWONII TENGGARA,1987,1312,3299
72551,SULAWESI TENGGARA,72786,KONAWE,72874,WAWONII TIMUR,1215,598,1813
72551,SULAWESI TENGGARA,72786,KONAWE,73120,WAWONII TIMUR LAUT,1155,795,1950
72551,SULAWESI TENGGARA,72786,KONAWE,72916,WAWONII UTARA,1356,1513,2869
72551,SULAWESI TENGGARA,72786,KONAWE,72807,WAWOTOBI,6238,4360,10598
72551,SULAWESI TENGGARA,72786,KONAWE,72985,WONGGEDUKU,7032,4378,11410
72551,SULAWESI TENGGARA,73650,KONAWE SELATAN,73697,ANDOOLO,4009,3923,7932
72551,SULAWESI TENGGARA,73650,KONAWE SELATAN,73673,ANGATA,3468,3687,7155
72551,SULAWESI TENGGARA,73650,KONAWE SELATAN,73989,BAITO,1667,1989,3656
72551,SULAWESI TENGGARA,73650,KONAWE SELATAN,73998,BASALA,677,3619,4296
72551,SULAWESI TENGGARA,73650,KONAWE SELATAN,73891,BENUA,1198,3498,4696
72551,SULAWESI TENGGARA,73650,KONAWE SELATAN,73947,BUKE,2594,4560,7154
72551,SULAWESI TENGGARA,73650,KONAWE SELATAN,73799,KOLONO,3025,4104,7129
72551,SULAWESI TENGGARA,73650,KONAWE SELATAN,73769,KONDA,4943,4268,9211
72551,SULAWESI TENGGARA,73650,KONAWE SELATAN,73971,LAEYA,4958,4171,9129
72551,SULAWESI TENGGARA,73650,KONAWE SELATAN,73756,LAINEA,2054,2446,4500
72551,SULAWESI TENGGARA,73650,KONAWE SELATAN,73872,LALEMBUU,2506,6209,8715
72551,SULAWESI TENGGARA,73650,KONAWE SELATAN,73734,LANDONO,3175,3524,6699
72551,SULAWESI TENGGARA,73650,KONAWE SELATAN,73851,LAONTI,2815,1852,4667
72551,SULAWESI TENGGARA,73650,KONAWE SELATAN,73830,MORAMO,3681,3629,7310
72551,SULAWESI TENGGARA,73650,KONAWE SELATAN,73936,MORAMO UTARA,1773,2109,3882
72551,SULAWESI TENGGARA,73650,KONAWE SELATAN,73915,MOWILA,2428,4203,6631
72551,SULAWESI TENGGARA,73650,KONAWE SELATAN,73718,PALANGGA,3677,2642,6319
72551,SULAWESI TENGGARA,73650,KONAWE SELATAN,73904,PALANGGA SELATAN,1331,1839,3170
72551,SULAWESI TENGGARA,73650,KONAWE SELATAN,73786,RANOMEETO,4481,3136,7617
72551,SULAWESI TENGGARA,73650,KONAWE SELATAN,74008,RANOMEETO BARAT,2191,1468,3659
72551,SULAWESI TENGGARA,73650,KONAWE SELATAN,73651,TINANGGEA,4743,6038,10781
72551,SULAWESI TENGGARA,73650,KONAWE SELATAN,73963,WOLASI,1347,1237,2584
72551,SULAWESI TENGGARA,74437,KONAWE UTARA,83768,ANDOWIA,1320,1884,3204
72551,SULAWESI TENGGARA,74437,KONAWE UTARA,74438,ASERA,1910,1849,3759
72551,SULAWESI TENGGARA,74437,KONAWE UTARA,74469,LANGGIKIMA,901,1578,2479
72551,SULAWESI TENGGARA,74437,KONAWE UTARA,74484,LASOLO,2852,3388,6240
72551,SULAWESI TENGGARA,74437,KONAWE UTARA,74502,LEMBO,1399,1208,2607
72551,SULAWESI TENGGARA,74437,KONAWE UTARA,74476,MOLAWE,1110,1803,2913
72551,SULAWESI TENGGARA,74437,KONAWE UTARA,83769,MOTUI,676,1098,1774
72551,SULAWESI TENGGARA,74437,KONAWE UTARA,83767,OHEO,1325,1200,2525
72551,SULAWESI TENGGARA,74437,KONAWE UTARA,74512,SAWA,981,1382,2363
72551,SULAWESI TENGGARA,74437,KONAWE UTARA,74459,WIWIRANO,1771,2888,4659
72551,SULAWESI TENGGARA,74665,KOTA BAU BAU,83766,BATUPOARO,4798,8032,12830
72551,SULAWESI TENGGARA,74665,KOTA BAU BAU,74666,BETOAMBARI,3826,3905,7731
72551,SULAWESI TENGGARA,74665,KOTA BAU BAU,74685,BUNGI,1468,2253,3721
72551,SULAWESI TENGGARA,74665,KOTA BAU BAU,74691,KOKALUKUNA,3464,4453,7917
72551,SULAWESI TENGGARA,74665,KOTA BAU BAU,74698,MURHUM,3968,5653,9621
72551,SULAWESI TENGGARA,74665,KOTA BAU BAU,74680,SORA WALIO,1509,1645,3154
72551,SULAWESI TENGGARA,74665,KOTA BAU BAU,74672,WOLIO,8115,9768,17883
72551,SULAWESI TENGGARA,74590,KOTA KENDARI,74628,ABELI,5658,6465,12123
72551,SULAWESI TENGGARA,74590,KOTA KENDARI,74608,BARUGA,4871,5547,10418
72551,SULAWESI TENGGARA,74590,KOTA KENDARI,74649,KADIA,9703,10143,19846
72551,SULAWESI TENGGARA,74590,KOTA KENDARI,74660,KAMBU,6205,6121,12326
72551,SULAWESI TENGGARA,74590,KOTA KENDARI,74598,KENDARI,6397,7410,13807
72551,SULAWESI TENGGARA,74590,KOTA KENDARI,74618,KENDARI BARAT,9274,12711,21985
72551,SULAWESI TENGGARA,74590,KOTA KENDARI,74591,MANDONGA,8626,10097,18723
72551,SULAWESI TENGGARA,74590,KOTA KENDARI,74613,POASIA,6554,7268,13822
72551,SULAWESI TENGGARA,74590,KOTA KENDARI,74642,PUUWATU,8297,8003,16300
72551,SULAWESI TENGGARA,73150,MUNA,73277,BARANGKA,1690,965,2655
72551,SULAWESI TENGGARA,73150,MUNA,73229,BATALAIWARU,3129,1865,4994
72551,SULAWESI TENGGARA,73150,MUNA,73380,BATUKARA,478,575,1053
72551,SULAWESI TENGGARA,73150,MUNA,73329,BONE,1622,804,2426
72551,SULAWESI TENGGARA,73150,MUNA,73243,DURUKA,3004,2103,5107
72551,SULAWESI TENGGARA,73150,MUNA,73295,KABANGKA,2146,2348,4494
72551,SULAWESI TENGGARA,73150,MUNA,73305,KABAWO,2869,1901,4770
72551,SULAWESI TENGGARA,73150,MUNA,73234,KATOBU,8082,4828,12910
72551,SULAWESI TENGGARA,73150,MUNA,73355,KONTU KOWUNA,1139,585,1724
72551,SULAWESI TENGGARA,73150,MUNA,73270,KONTUNAGA,1919,1290,3209
72551,SULAWESI TENGGARA,73150,MUNA,73190,KUSAMBI,2535,1919,4454
72551,SULAWESI TENGGARA,73150,MUNA,73221,LASALEPA,2950,1581,4531
72551,SULAWESI TENGGARA,73150,MUNA,73286,LAWA,1866,1299,3165
72551,SULAWESI TENGGARA,73150,MUNA,73251,LOHIA,3458,2102,5560
72551,SULAWESI TENGGARA,73150,MUNA,73151,MAGINTI,1826,1688,3514
72551,SULAWESI TENGGARA,73150,MUNA,73208,MALIGANO,1200,1156,2356
72551,SULAWESI TENGGARA,73150,MUNA,73362,MAROBO,1023,1534,2557
72551,SULAWESI TENGGARA,73150,MUNA,73201,NAPABALANO,2730,1598,4328
72551,SULAWESI TENGGARA,73150,MUNA,73393,NAPANO KUSAMBI,1056,847,1903
72551,SULAWESI TENGGARA,73150,MUNA,73317,PARIGI,2490,1710,4200
72551,SULAWESI TENGGARA,73150,MUNA,73375,PASI KOLAGA,1069,579,1648
72551,SULAWESI TENGGARA,73150,MUNA,73348,PASIR PUTIH,1124,740,1864
72551,SULAWESI TENGGARA,73150,MUNA,73179,SEWERGADI,62,79,141
72551,SULAWESI TENGGARA,73150,MUNA,73169,TIWORO KEPULAUAN,1810,1257,3067
72551,SULAWESI TENGGARA,73150,MUNA,73406,TIWORO SELATAN,969,1331,2300
72551,SULAWESI TENGGARA,73150,MUNA,73160,TIWORO TENGAH,1528,1710,3238
72551,SULAWESI TENGGARA,73150,MUNA,73412,TIWORO UTARA,1313,1135,2448
72551,SULAWESI TENGGARA,73150,MUNA,73335,TONGKUNO,3262,2121,5383
72551,SULAWESI TENGGARA,73150,MUNA,73368,TONGKUNO SELATAN,930,1335,2265
72551,SULAWESI TENGGARA,73150,MUNA,73400,TOWEA,1382,730,2112
72551,SULAWESI TENGGARA,73150,MUNA,73385,WA DAGA,1303,911,2214
72551,SULAWESI TENGGARA,73150,MUNA,73215,WAKORUMBA SELATAN,1091,658,1749
72551,SULAWESI TENGGARA,73150,MUNA,73261,WATOPUTE,2870,2208,5078
72551,SULAWESI TENGGARA,74179,WAKATOBI,74229,BINONGKO,1252,2407,3659
72551,SULAWESI TENGGARA,74179,WAKATOBI,74201,KALEDUPA,1618,3381,4999
72551,SULAWESI TENGGARA,74179,WAKATOBI,74261,KALEDUPA SELATAN,897,2502,3399
72551,SULAWESI TENGGARA,74179,WAKATOBI,74282,TOGO BINONGKO,726,1428,2154
72551,SULAWESI TENGGARA,74179,WAKATOBI,74218,TOMIA,1099,2588,3687
72551,SULAWESI TENGGARA,74179,WAKATOBI,74272,TOMIA TIMUR,816,3422,4238
72551,SULAWESI TENGGARA,74179,WAKATOBI,74239,WANGI WANGI SELATAN,4273,7920,12193
65702,SULAWESI UTARA,65822,BOLAANG MONGONDOW,65968,BILALANG,2263,531,2794
65702,SULAWESI UTARA,65822,BOLAANG MONGONDOW,65900,BOLAANG,6054,2695,8749
65702,SULAWESI UTARA,65822,BOLAANG MONGONDOW,65960,BOLAANG TIMUR,4188,1535,5723
65702,SULAWESI UTARA,65822,BOLAANG MONGONDOW,83401,DUMOGA,3961,3455,7416
65702,SULAWESI UTARA,65822,BOLAANG MONGONDOW,65834,DUMOGA BARAT,5346,2746,8092
65702,SULAWESI UTARA,65822,BOLAANG MONGONDOW,83778,DUMOGA TENGAH,3068,2680,5748
65702,SULAWESI UTARA,65822,BOLAANG MONGONDOW,83779,DUMOGA TENGGARA,2872,1356,4228
65702,SULAWESI UTARA,65822,BOLAANG MONGONDOW,65846,DUMOGA TIMUR,5470,5135,10605
65702,SULAWESI UTARA,65822,BOLAANG MONGONDOW,65864,DUMOGA UTARA,4491,3112,7603
65702,SULAWESI UTARA,65822,BOLAANG MONGONDOW,65878,LOLAK,7309,6815,14124
65702,SULAWESI UTARA,65822,BOLAANG MONGONDOW,65908,LOLAYAN,8916,3691,12607
65702,SULAWESI UTARA,65822,BOLAANG MONGONDOW,65923,PASSI BARAT,6907,1547,8454
65702,SULAWESI UTARA,65822,BOLAANG MONGONDOW,65952,PASSI TIMUR,3640,2829,6469
65702,SULAWESI UTARA,65822,BOLAANG MONGONDOW,65934,POIGAR,5678,4073,9751
65702,SULAWESI UTARA,65822,BOLAANG MONGONDOW,65823,SANG TOMBOLANG,3113,2170,5283
65702,SULAWESI UTARA,65760,BOLAANG MONGONDOW SELATAN,65761,BOLAANG UKI,7350,4511,11861
65702,SULAWESI UTARA,65760,BOLAANG MONGONDOW SELATAN,65796,PINOLOSIAN,2984,2449,5433
65702,SULAWESI UTARA,65760,BOLAANG MONGONDOW SELATAN,65806,PINOLOSIAN TENGAH,1977,983,2960
65702,SULAWESI UTARA,65760,BOLAANG MONGONDOW SELATAN,65812,PINOLOSIAN TIMUR,1804,2110,3914
65702,SULAWESI UTARA,65760,BOLAANG MONGONDOW SELATAN,65780,POSIGADAN,5509,4442,9951
65702,SULAWESI UTARA,65703,BOLAANG MONGONDOW TIMUR,65714,KOTABUNAN,4148,2233,6381
65702,SULAWESI UTARA,65703,BOLAANG MONGONDOW TIMUR,65736,MODAYAG,6265,4451,10716
65702,SULAWESI UTARA,65703,BOLAANG MONGONDOW TIMUR,65754,MODAYAG BARAT,3671,1475,5146
65702,SULAWESI UTARA,65703,BOLAANG MONGONDOW TIMUR,65722,NUANGAN,5129,2603,7732
65702,SULAWESI UTARA,65703,BOLAANG MONGONDOW TIMUR,65704,TUTUYAN,3710,3102,6812
65702,SULAWESI UTARA,66936,BOLAANG MONGONDOW UTARA,66949,BINTAUNA,4309,3285,7594
65702,SULAWESI UTARA,66936,BOLAANG MONGONDOW UTARA,66982,BOLANGITANG BARAT,4352,3261,7613
65702,SULAWESI UTARA,66936,BOLAANG MONGONDOW UTARA,66965,BOLANGITANG TIMUR,3927,2998,6925
65702,SULAWESI UTARA,66936,BOLAANG MONGONDOW UTARA,66999,KAIDIPANG,3943,2987,6930
65702,SULAWESI UTARA,66936,BOLAANG MONGONDOW UTARA,67013,PINOGALUMAN,3215,2675,5890
65702,SULAWESI UTARA,66936,BOLAANG MONGONDOW UTARA,66937,SANGKUB,2426,2806,5232
65702,SULAWESI UTARA,66188,KEPULAUAN SANGIHE,66316,KENDAHE,2113,1868,3981
65702,SULAWESI UTARA,66188,KEPULAUAN SANGIHE,66367,KEPULAUAN MARORE,307,423,730
65702,SULAWESI UTARA,66188,KEPULAUAN SANGIHE,66263,MANGANITU,1989,6634,8623
65702,SULAWESI UTARA,66188,KEPULAUAN SANGIHE,66220,MANGANITU SELATAN,1603,4340,5943
65702,SULAWESI UTARA,66188,KEPULAUAN SANGIHE,66214,NUSA TABUKAN,1252,526,1778
65702,SULAWESI UTARA,66188,KEPULAUAN SANGIHE,66301,TABUKAN SELATAN,1177,2319,3496
65702,SULAWESI UTARA,66188,KEPULAUAN SANGIHE,66334,TABUKAN SELATAN TENGAH,389,1182,1571
65702,SULAWESI UTARA,66188,KEPULAUAN SANGIHE,66344,TABUKAN SELATAN TENGGARA,188,1131,1319
65702,SULAWESI UTARA,66188,KEPULAUAN SANGIHE,66282,TABUKAN TENGAH,1961,4347,6308
65702,SULAWESI UTARA,66188,KEPULAUAN SANGIHE,66189,TABUKAN UTARA,6068,5400,11468
65702,SULAWESI UTARA,66188,KEPULAUAN SANGIHE,66325,TAHUNA,3446,5335,8781
65702,SULAWESI UTARA,66188,KEPULAUAN SANGIHE,66351,TAHUNA BARAT,1011,2532,3543
65702,SULAWESI UTARA,66188,KEPULAUAN SANGIHE,66358,TAHUNA TIMUR,3401,3754,7155
65702,SULAWESI UTARA,66188,KEPULAUAN SANGIHE,66242,TAMAKO,2372,5660,8032
65702,SULAWESI UTARA,66188,KEPULAUAN SANGIHE,66234,TATOARENG,941,1454,2395
65702,SULAWESI UTARA,66371,KEPULAUAN TALAUD,66380,BEO,911,2199,3110
65702,SULAWESI UTARA,66371,KEPULAUAN TALAUD,66526,BEO SELATAN,383,1807,2190
65702,SULAWESI UTARA,66371,KEPULAUAN TALAUD,66497,BEO UTARA,406,1911,2317
65702,SULAWESI UTARA,66371,KEPULAUAN TALAUD,66461,DAMAU,684,2089,2773
65702,SULAWESI UTARA,66371,KEPULAUAN TALAUD,66399,ESSANG,677,1274,1951
65702,SULAWESI UTARA,66371,KEPULAUAN TALAUD,66534,ESSANG SELATAN,412,1505,1917
65702,SULAWESI UTARA,66371,KEPULAUAN TALAUD,66445,GEMEH,651,2480,3131
65702,SULAWESI UTARA,66371,KEPULAUAN TALAUD,66418,KABARUAN,1036,2326,3362
65702,SULAWESI UTARA,66371,KEPULAUAN TALAUD,66489,KALONGAN,475,1498,1973
65702,SULAWESI UTARA,66371,KEPULAUAN TALAUD,66372,LIRUNG,1118,2571,3689
65702,SULAWESI UTARA,66371,KEPULAUAN TALAUD,66431,MELONGUANE,1202,4950,6152
65702,SULAWESI UTARA,66371,KEPULAUAN TALAUD,66512,MELONGUANE TIMUR,220,1721,1941
65702,SULAWESI UTARA,66371,KEPULAUAN TALAUD,66495,MIANGAS,346,131,477
65702,SULAWESI UTARA,66371,KEPULAUAN TALAUD,66519,MORONGE,372,2030,2402
65702,SULAWESI UTARA,66371,KEPULAUAN TALAUD,66408,NANUSA,461,1759,2220
65702,SULAWESI UTARA,66371,KEPULAUAN TALAUD,66506,PULUTAN,230,1158,1388
65702,SULAWESI UTARA,66371,KEPULAUAN TALAUD,66387,RAINIS,912,2564,3476
65702,SULAWESI UTARA,66371,KEPULAUAN TALAUD,66482,SALIBABU,490,3054,3544
65702,SULAWESI UTARA,67227,KOTA BITUNG,67257,AERTEMBAGA,5372,9769,15141
65702,SULAWESI UTARA,67227,KOTA BITUNG,67277,GIRIAN,7739,7894,15633
65702,SULAWESI UTARA,67227,KOTA BITUNG,67228,LEMBEH SELATAN,1874,3465,5339
65702,SULAWESI UTARA,67227,KOTA BITUNG,67294,LEMBEH UTARA,1601,3613,5214
65702,SULAWESI UTARA,67227,KOTA BITUNG,67236,MADIDIR,6453,10788,17241
65702,SULAWESI UTARA,67227,KOTA BITUNG,67285,MAESA,7912,10676,18588
65702,SULAWESI UTARA,67227,KOTA BITUNG,67268,MATUARI,6693,8791,15484
65702,SULAWESI UTARA,67227,KOTA BITUNG,67245,RANOWULU,3990,5826,9816
65702,SULAWESI UTARA,67355,KOTA KOTAMOBAGU,67386,KOTAMOBAGU BARAT,12375,7822,20197
65702,SULAWESI UTARA,67355,KOTA KOTAMOBAGU,67376,KOTAMOBAGU SELATAN,11344,3986,15330
65702,SULAWESI UTARA,67355,KOTA KOTAMOBAGU,67365,KOTAMOBAGU TIMUR,10392,4909,15301
65702,SULAWESI UTARA,67355,KOTA KOTAMOBAGU,67356,KOTAMOBAGU UTARA,6292,1642,7934
65702,SULAWESI UTARA,67130,KOTA MANADO,67131,BUNAKEN,4428,6979,11407
65702,SULAWESI UTARA,67130,KOTA MANADO,83792,BUNAKEN KEPULAUAN,1232,2454,3686
65702,SULAWESI UTARA,67130,KOTA MANADO,67217,MALALAYANG,13513,19726,33239
65702,SULAWESI UTARA,67130,KOTA MANADO,67205,MAPANGET,10914,15891,26805
65702,SULAWESI UTARA,67130,KOTA MANADO,83793,PAAL DUA,8885,14326,23211
65702,SULAWESI UTARA,67130,KOTA MANADO,67187,SARIO,5209,6556,11765
65702,SULAWESI UTARA,67130,KOTA MANADO,67151,SINGKIL,10854,14405,25259
65702,SULAWESI UTARA,67130,KOTA MANADO,67174,TIKALA,6045,9586,15631
65702,SULAWESI UTARA,67130,KOTA MANADO,67140,TUMINITING,11647,15979,27626
65702,SULAWESI UTARA,67130,KOTA MANADO,67195,WANEA,13200,17937,31137
65702,SULAWESI UTARA,67130,KOTA MANADO,67161,WENANG,8481,10733,19214
65702,SULAWESI UTARA,67305,KOTA TOMOHON,67340,TOMOHON BARAT,4416,5000,9416
65702,SULAWESI UTARA,67305,KOTA TOMOHON,67306,TOMOHON SELATAN,6415,7323,13738
65702,SULAWESI UTARA,67305,KOTA TOMOHON,67319,TOMOHON TENGAH,5233,6321,11554
65702,SULAWESI UTARA,67305,KOTA TOMOHON,67349,TOMOHON TIMUR,2929,3626,6555
65702,SULAWESI UTARA,67305,KOTA TOMOHON,67329,TOMOHON UTARA,7144,9131,16275
65702,SULAWESI UTARA,65974,MINAHASA,65997,ERIS,2804,3664,6468
65702,SULAWESI UTARA,65974,MINAHASA,66025,KAKAS,3378,4131,7509
65702,SULAWESI UTARA,65974,MINAHASA,83780,KAKAS BARAT,2291,3708,5999
65702,SULAWESI UTARA,65974,MINAHASA,66100,KAWANGKOAN,2307,4212,6519
65702,SULAWESI UTARA,65974,MINAHASA,83782,KAWANGKOAN BARAT,2303,3453,5756
65702,SULAWESI UTARA,65974,MINAHASA,83781,KAWANGKOAN UTARA,1769,3780,5549
65702,SULAWESI UTARA,65974,MINAHASA,66005,KOMBI,2854,4066,6920
65702,SULAWESI UTARA,65974,MINAHASA,66078,LANGOWAN BARAT,4557,5724,10281
65702,SULAWESI UTARA,65974,MINAHASA,66161,LANGOWAN SELATAN,2492,2614,5106
65702,SULAWESI UTARA,65974,MINAHASA,66070,LANGOWAN TIMUR,4131,3882,8013
65702,SULAWESI UTARA,65974,MINAHASA,66180,LANGOWAN UTARA,2214,3310,5524
65702,SULAWESI UTARA,65974,MINAHASA,66017,LEMBEAN TIMUR,2283,2891,5174
65702,SULAWESI UTARA,65974,MINAHASA,83783,MANDOLANG,4809,6399,11208
65702,SULAWESI UTARA,65974,MINAHASA,66114,PINELENG,7784,8964,16748
65702,SULAWESI UTARA,65974,MINAHASA,66058,REMBOKEN,2764,4355,7119
65702,SULAWESI UTARA,65974,MINAHASA,66089,SONDER,4325,7545,11870
65702,SULAWESI UTARA,65974,MINAHASA,66138,TOMBARIRI,5013,5281,10294
65702,SULAWESI UTARA,65974,MINAHASA,83784,TOMBARIRI TIMUR,2649,3012,5661
65702,SULAWESI UTARA,65974,MINAHASA,66129,TOMBULU,3466,6265,9731
65702,SULAWESI UTARA,65974,MINAHASA,66046,TOMPASO,1501,3459,4960
65702,SULAWESI UTARA,65974,MINAHASA,83785,TOMPASO BARAT,2511,3020,5531
65702,SULAWESI UTARA,65974,MINAHASA,65975,TONDANO BARAT,5290,5546,10836
65702,SULAWESI UTARA,65974,MINAHASA,66171,TONDANO SELATAN,4410,5863,10273
65702,SULAWESI UTARA,65974,MINAHASA,65985,TONDANO TIMUR,3905,4837,8742
65702,SULAWESI UTARA,65974,MINAHASA,66153,TONDANO UTARA,3608,3168,6776
65702,SULAWESI UTARA,66544,MINAHASA SELATAN,66613,AMURANG,4344,4914,9258
65702,SULAWESI UTARA,66544,MINAHASA SELATAN,66661,AMURANG BARAT,3898,5413,9311
65702,SULAWESI UTARA,66544,MINAHASA SELATAN,66671,AMURANG TIMUR,3774,3937,7711
65702,SULAWESI UTARA,66544,MINAHASA SELATAN,66643,KUMELEMBUAI,1645,2712,4357
65702,SULAWESI UTARA,66544,MINAHASA SELATAN,66651,MAESAAN,2394,3572,5966
65702,SULAWESI UTARA,66544,MINAHASA SELATAN,66545,MODOINDING,2776,4283,7059
65702,SULAWESI UTARA,66544,MINAHASA SELATAN,66577,MOTOLING,2204,2558,4762
65702,SULAWESI UTARA,66544,MINAHASA SELATAN,66692,MOTOLING BARAT,1890,2978,4868
65702,SULAWESI UTARA,66544,MINAHASA SELATAN,66701,MOTOLING TIMUR,1469,4055,5524
65702,SULAWESI UTARA,66544,MINAHASA SELATAN,66565,RANOYAPO,3011,4201,7212
65702,SULAWESI UTARA,66544,MINAHASA SELATAN,66585,SINONSAYANG,4754,4450,9204
65702,SULAWESI UTARA,66544,MINAHASA SELATAN,66710,SULUUN TARERAN,2407,2442,4849
65702,SULAWESI UTARA,66544,MINAHASA SELATAN,66633,TARERAN,3388,4581,7969
65702,SULAWESI UTARA,66544,MINAHASA SELATAN,66680,TATAPAAN,2598,3157,5755
65702,SULAWESI UTARA,66544,MINAHASA SELATAN,66596,TENGA,5314,5611,10925
65702,SULAWESI UTARA,66544,MINAHASA SELATAN,66554,TOMPASO BARU,3422,3503,6925
65702,SULAWESI UTARA,66544,MINAHASA SELATAN,66622,TUMPAAN,4318,5141,9459
65702,SULAWESI UTARA,66853,MINAHASA TENGGARA,66879,BELANG,5547,3529,9076
65702,SULAWESI UTARA,66853,MINAHASA TENGGARA,83790,PASAN,1834,2815,4649
65702,SULAWESI UTARA,66853,MINAHASA TENGGARA,66870,PUSOMAEN,3375,2007,5382
65702,SULAWESI UTARA,66853,MINAHASA TENGGARA,66854,RATAHAN,3677,4341,8018
65702,SULAWESI UTARA,66853,MINAHASA TENGGARA,83791,RATAHAN TIMUR,2093,1957,4050
65702,SULAWESI UTARA,66853,MINAHASA TENGGARA,66890,RATATOTOK,3762,3725,7487
65702,SULAWESI UTARA,66853,MINAHASA TENGGARA,83787,SILIAN RAYA,1609,1737,3346
65702,SULAWESI UTARA,66853,MINAHASA TENGGARA,66900,TOMBATU,2757,2446,5203
65702,SULAWESI UTARA,66853,MINAHASA TENGGARA,83788,TOMBATU TIMUR,2330,3434,5764
65702,SULAWESI UTARA,66853,MINAHASA TENGGARA,83789,TOMBATU UTARA,2404,2469,4873
65702,SULAWESI UTARA,66853,MINAHASA TENGGARA,66918,TOULUAAN,1914,1972,3886
65702,SULAWESI UTARA,66853,MINAHASA TENGGARA,83786,TOULUAAN SELATAN,1568,1005,2573
65702,SULAWESI UTARA,66718,MINAHASA UTARA,66742,AIRMADIDI,7598,7397,14995
65702,SULAWESI UTARA,66718,MINAHASA UTARA,66772,DIMEMBE,8125,6157,14282
65702,SULAWESI UTARA,66718,MINAHASA UTARA,66819,KALAWAT,6755,9630,16385
65702,SULAWESI UTARA,66718,MINAHASA UTARA,66729,KAUDITAN,7207,7276,14483
65702,SULAWESI UTARA,66718,MINAHASA UTARA,66719,KEMA,4541,3985,8526
65702,SULAWESI UTARA,66718,MINAHASA UTARA,66784,LIKUPANG BARAT,4195,6208,10403
65702,SULAWESI UTARA,66718,MINAHASA UTARA,66845,LIKUPANG SELATAN,1975,1280,3255
65702,SULAWESI UTARA,66718,MINAHASA UTARA,66803,LIKUPANG TIMUR,4026,7160,11186
65702,SULAWESI UTARA,66718,MINAHASA UTARA,66832,TALAWAAN,5732,5356,11088
65702,SULAWESI UTARA,66718,MINAHASA UTARA,66752,WORI,5206,6171,11377
12920,SUMATERA BARAT,13317,AGAM,13398,AMPEK NAGARI,8612,2306,10918
12920,SUMATERA BARAT,13317,AGAM,13353,BANUHAMPU,14317,2522,16839
12920,SUMATERA BARAT,13317,AGAM,13369,BASO,12864,2871,15735
12920,SUMATERA BARAT,13317,AGAM,13403,CANDUNG,8670,1787,10457
12920,SUMATERA BARAT,13317,AGAM,13361,IV ANGKAT CANDUNG,15606,3746,19352
12920,SUMATERA BARAT,13317,AGAM,13345,IV KOTO,9894,1639,11533
12920,SUMATERA BARAT,13317,AGAM,13407,KAMANG MAGEK,9425,1691,11116
12920,SUMATERA BARAT,13317,AGAM,13322,LUBUK BASUNG,23529,6334,29863
12920,SUMATERA BARAT,13317,AGAM,13411,MALALAK,3628,613,4241
12920,SUMATERA BARAT,13317,AGAM,13338,MATUR,7477,1340,8817
12920,SUMATERA BARAT,13317,AGAM,13380,PALUPUH,5158,1242,6400
12920,SUMATERA BARAT,13317,AGAM,13385,PELEMBAYAN,11355,2205,13560
12920,SUMATERA BARAT,13317,AGAM,13392,SUNGAI PUA,9093,1753,10846
12920,SUMATERA BARAT,13317,AGAM,13318,TANJUNG MUTIARA,0,0,0
12920,SUMATERA BARAT,13317,AGAM,13328,TANJUNG RAYA,13017,2843,15860
12920,SUMATERA BARAT,13317,AGAM,13376,TILATANG KAMANG,14173,2953,17126
12920,SUMATERA BARAT,13608,DHARMASRAYA,83415,ASAM JUJUHAN,4257,1595,5852
12920,SUMATERA BARAT,13608,DHARMASRAYA,13609,KOTO BARU,11072,4531,15603
12920,SUMATERA BARAT,13608,DHARMASRAYA,83416,KOTO BESAR,7452,4523,11975
12920,SUMATERA BARAT,13608,DHARMASRAYA,83412,KOTO SALAK,5324,4371,9695
12920,SUMATERA BARAT,13608,DHARMASRAYA,83414,PADANG LAWEH,1983,1169,3152
12920,SUMATERA BARAT,13608,DHARMASRAYA,13617,PULAU PUNJUNG,14604,4167,18771
12920,SUMATERA BARAT,13608,DHARMASRAYA,83410,SEMBILAN KOTO,2602,1145,3747
12920,SUMATERA BARAT,13608,DHARMASRAYA,13630,SITIUNG,9578,3881,13459
12920,SUMATERA BARAT,13608,DHARMASRAYA,13623,SUNGAI RUMBAI,5003,4837,9840
12920,SUMATERA BARAT,13608,DHARMASRAYA,83411,TIMPEH,4678,3173,7851
12920,SUMATERA BARAT,13608,DHARMASRAYA,83413,TIUMANG,3588,3345,6933
12920,SUMATERA BARAT,13554,KEPULAUAN MENTAWAI,13603,PAGAI SELATAN,0,0,0
12920,SUMATERA BARAT,13554,KEPULAUAN MENTAWAI,13555,PAGAI UTARA,0,0,0
12920,SUMATERA BARAT,13554,KEPULAUAN MENTAWAI,13580,SIBERUT BARAT,0,0,0
12920,SUMATERA BARAT,13554,KEPULAUAN MENTAWAI,13584,SIBERUT BARAT DAYA,0,0,0
12920,SUMATERA BARAT,13554,KEPULAUAN MENTAWAI,13567,SIBERUT SELATAN,0,0,0
12920,SUMATERA BARAT,13554,KEPULAUAN MENTAWAI,13588,SIBERUT TENGAH,0,0,0
12920,SUMATERA BARAT,13554,KEPULAUAN MENTAWAI,13573,SIBERUT UTARA,0,0,0
12920,SUMATERA BARAT,13554,KEPULAUAN MENTAWAI,13599,SIKAKAP,0,0,0
12920,SUMATERA BARAT,13554,KEPULAUAN MENTAWAI,13559,SIPORA SELATAN,0,0,0
12920,SUMATERA BARAT,13554,KEPULAUAN MENTAWAI,13592,SIPORA UTARA,0,0,0
12920,SUMATERA BARAT,13905,KOTA BUKITTINGGI,13924,AUR BIRUGO TIGO BALEH,9145,1894,11039
12920,SUMATERA BARAT,13905,KOTA BUKITTINGGI,13906,GUGUAK PANJANG,14470,3681,18151
12920,SUMATERA BARAT,13712,KOTA PADANG,13756,BUNGUS TELUK KABUNG,8788,1516,10304
12920,SUMATERA BARAT,13712,KOTA PADANG,13814,KOTO TANGAH,59982,17433,77415
12920,SUMATERA BARAT,13712,KOTA PADANG,13797,KURANJI,49937,9780,59717
12920,SUMATERA BARAT,13712,KOTA PADANG,13763,LUBUK BEGALUNG,40781,10537,51318
12920,SUMATERA BARAT,13712,KOTA PADANG,13779,LUBUK KILANGAN,18849,4298,23147
12920,SUMATERA BARAT,13712,KOTA PADANG,13807,NANGGALO,21193,5640,26833
12920,SUMATERA BARAT,13712,KOTA PADANG,13737,PADANG BARAT,14282,8106,22388
12920,SUMATERA BARAT,13712,KOTA PADANG,13713,PADANG SELATAN,18798,9241,28039
12920,SUMATERA BARAT,13712,KOTA PADANG,13726,PADANG TIMUR,29436,7665,37101
12920,SUMATERA BARAT,13712,KOTA PADANG,13748,PADANG UTARA,20697,5443,26140
12920,SUMATERA BARAT,13712,KOTA PADANG,13787,PAUH,22107,4039,26146
12920,SUMATERA BARAT,13886,KOTA PADANG PANJANG,13896,PADANG PANJANG BARAT,10980,2616,13596
12920,SUMATERA BARAT,13886,KOTA PADANG PANJANG,13887,PADANG PANJANG TIMUR,7967,1786,9753
12920,SUMATERA BARAT,14010,KOTA PARIAMAN,14052,PARIAMAN SELATAN,6952,1198,8150
12920,SUMATERA BARAT,14010,KOTA PARIAMAN,14011,PARIAMAN TENGAH,12517,2697,15214
12920,SUMATERA BARAT,14010,KOTA PARIAMAN,14069,PARIAMAN TIMUR,6606,1123,7729
12920,SUMATERA BARAT,14010,KOTA PARIAMAN,14034,PARIAMAN UTARA,7904,1652,9556
12920,SUMATERA BARAT,13933,KOTA PAYAKUMBUH,83417,LAMPOSI TIGO NAGORI,3908,796,4704
12920,SUMATERA BARAT,13933,KOTA PAYAKUMBUH,13934,PAYAKUMBUH BARAT,17746,4672,22418
12920,SUMATERA BARAT,13933,KOTA PAYAKUMBUH,83418,PAYAKUMBUH SELATAN,4221,884,5105
12920,SUMATERA BARAT,13933,KOTA PAYAKUMBUH,13995,PAYAKUMBUH TIMUR,9517,2883,12400
12920,SUMATERA BARAT,13933,KOTA PAYAKUMBUH,13966,PAYAKUMBUH UTARA,11739,2515,14254
12920,SUMATERA BARAT,13844,KOTA SAWAHLUNTO,13857,BARANGIN,7000,2017,9017
12920,SUMATERA BARAT,13844,KOTA SAWAHLUNTO,13845,LEMBAH SEGAR,5128,1387,6515
12920,SUMATERA BARAT,13844,KOTA SAWAHLUNTO,13868,SILUNGKANG,3880,1097,4977
12920,SUMATERA BARAT,13844,KOTA SAWAHLUNTO,13874,TALAWI,7466,2165,9631
12920,SUMATERA BARAT,13828,KOTA SOLOK,13829,LUBUK SIKARAH,14393,2644,17037
12920,SUMATERA BARAT,13828,KOTA SOLOK,13837,TANJUNG HARAPAN,11256,2426,13682
12920,SUMATERA BARAT,13416,LIMA PULUH KOTA,13501,AKABILURU,10465,1721,12186
12920,SUMATERA BARAT,13416,LIMA PULUH KOTA,13495,BUKIK BARISAN,9332,1789,11121
12920,SUMATERA BARAT,13416,LIMA PULUH KOTA,13424,GUGUAK,13440,4045,17485
12920,SUMATERA BARAT,13416,LIMA PULUH KOTA,13470,GUNUANG OMEH,4834,1426,6260
12920,SUMATERA BARAT,13416,LIMA PULUH KOTA,13443,HARAU,17964,4949,22913
12920,SUMATERA BARAT,13416,LIMA PULUH KOTA,13462,KAPUR IX,8460,2862,11322
12920,SUMATERA BARAT,13416,LIMA PULUH KOTA,13474,LAREH SAGO HALABAN,14331,4617,18948
12920,SUMATERA BARAT,13416,LIMA PULUH KOTA,13438,LUAK,11062,2388,13450
12920,SUMATERA BARAT,13416,LIMA PULUH KOTA,13489,MUNGKA,9650,2084,11734
12920,SUMATERA BARAT,13416,LIMA PULUH KOTA,13455,PANGKALAN KOTO BARU,10502,2272,12774
12920,SUMATERA BARAT,13416,LIMA PULUH KOTA,13430,PAYAKUMBUH,12815,2761,15576
12920,SUMATERA BARAT,13416,LIMA PULUH KOTA,13483,SITUJUAH LIMO NAGARI,8640,2074,10714
12920,SUMATERA BARAT,13416,LIMA PULUH KOTA,13417,SULIKI,5588,1711,7299
12920,SUMATERA BARAT,13253,PADANG PARIAMAN,13304,2 X 11 ENAM LINGKUNG,5922,2390,8312
12920,SUMATERA BARAT,13253,PADANG PARIAMAN,13266,2 X 11 KAYU TANAM,8807,2678,11485
12920,SUMATERA BARAT,13253,PADANG PARIAMAN,13256,BATANG ANAI,14936,3786,18722
12920,SUMATERA BARAT,13253,PADANG PARIAMAN,13297,BATANG GASAN,4503,811,5314
12920,SUMATERA BARAT,13253,PADANG PARIAMAN,13311,ENAM LINGKUNG,7414,1835,9249
12920,SUMATERA BARAT,13253,PADANG PARIAMAN,13285,IV KOTO AUR MALINTANG,6398,1674,8072
12920,SUMATERA BARAT,13253,PADANG PARIAMAN,13254,LUBUK ALUNG,14807,3443,18250
12920,SUMATERA BARAT,13253,PADANG PARIAMAN,13260,NAN SABARIS,10825,2050,12875
12920,SUMATERA BARAT,13253,PADANG PARIAMAN,13293,PADANG SAGO,3017,1001,4018
12920,SUMATERA BARAT,13253,PADANG PARIAMAN,13308,PATAMUAN,5676,1688,7364
12920,SUMATERA BARAT,13253,PADANG PARIAMAN,13290,SINTUAK TOBOH GADANG,6880,1660,8540
12920,SUMATERA BARAT,13253,PADANG PARIAMAN,13279,SUNGAI GARINGGING,8524,3051,11575
12920,SUMATERA BARAT,13253,PADANG PARIAMAN,13282,SUNGAI LIMAU,10420,2269,12689
12920,SUMATERA BARAT,13253,PADANG PARIAMAN,13287,ULAKAN TAPAKIH,6696,1771,8467
12920,SUMATERA BARAT,13253,PADANG PARIAMAN,13276,V KOTO KAMPUNG DALAM,8863,1924,10787
12920,SUMATERA BARAT,13253,PADANG PARIAMAN,13300,V KOTO TIMUR,5615,1130,6745
12920,SUMATERA BARAT,13253,PADANG PARIAMAN,13271,VII KOTO SUNGAI SARIK,11635,4194,15829
12920,SUMATERA BARAT,13509,PASAMAN,13510,BONJOL,8207,1880,10087
12920,SUMATERA BARAT,13509,PASAMAN,13528,DUO KOTO,7767,3060,10827
12920,SUMATERA BARAT,13509,PASAMAN,13515,LUBUK SIKAPING,19038,3231,22269
12920,SUMATERA BARAT,13509,PASAMAN,13524,MAPAT TUNGGUL,2915,1845,4760
12920,SUMATERA BARAT,13509,PASAMAN,13538,MAPAT TUNGGUL SELATAN,3120,1120,4240
12920,SUMATERA BARAT,13509,PASAMAN,13544,PADANG GELUGUR,10148,2766,12914
12920,SUMATERA BARAT,13509,PASAMAN,13522,PANTI,9871,3635,13506
12920,SUMATERA BARAT,13509,PASAMAN,13535,RAO,7961,3385,11346
12920,SUMATERA BARAT,13509,PASAMAN,13550,RAO SELATAN,8978,2319,11297
12920,SUMATERA BARAT,13509,PASAMAN,13546,RAO UTARA,4623,1040,5663
12920,SUMATERA BARAT,13509,PASAMAN,13541,SIMPANG ALAHAN MATI,3971,661,4632
12920,SUMATERA BARAT,13509,PASAMAN,13531,TIGO NAGARI,7644,1702,9346
12920,SUMATERA BARAT,13681,PASAMAN BARAT,13697,GUNUNG TULEH,0,0,0
12920,SUMATERA BARAT,13681,PASAMAN BARAT,13694,KINALI,20039,8905,28944
12920,SUMATERA BARAT,13681,PASAMAN BARAT,13703,KOTO BALINGKA,8334,3546,11880
12920,SUMATERA BARAT,13681,PASAMAN BARAT,13684,LEMBAH MELINTANG,14078,3312,17390
12920,SUMATERA BARAT,13681,PASAMAN BARAT,13707,LUHAK NAN DUO,13729,5522,19251
12920,SUMATERA BARAT,13681,PASAMAN BARAT,13686,PASAMAN,23134,5883,29017
12920,SUMATERA BARAT,13681,PASAMAN BARAT,13700,RANAH BATAHAN,9098,3287,12385
12920,SUMATERA BARAT,13681,PASAMAN BARAT,13710,SASAK RANAH PESISIA,4940,1703,6643
12920,SUMATERA BARAT,13681,PASAMAN BARAT,13705,SUNGAI AUA,10071,4072,14143
12920,SUMATERA BARAT,13681,PASAMAN BARAT,13682,SUNGAI BEREMAS,7121,1775,8896
12920,SUMATERA BARAT,13681,PASAMAN BARAT,13690,TALAMAU,11156,1890,13046
12920,SUMATERA BARAT,12921,PESISIR SELATAN,83473,AIRPURA,3805,2483,6288
12920,SUMATERA BARAT,12921,PESISIR SELATAN,12996,BASA AMPEK BALAI TAPAN,3384,2180,5564
12920,SUMATERA BARAT,12921,PESISIR SELATAN,12946,BATANG KAPAS,9918,3763,13681
12920,SUMATERA BARAT,12921,PESISIR SELATAN,12959,BAYANG,16018,3220,19238
12920,SUMATERA BARAT,12921,PESISIR SELATAN,12952,IV JURAI,17408,5299,22707
12920,SUMATERA BARAT,12921,PESISIR SELATAN,13005,IV NAGARI BAYANG UTARA,3711,549,4260
12920,SUMATERA BARAT,12921,PESISIR SELATAN,12964,KOTO XI TARUSAN,16477,5388,21865
12920,SUMATERA BARAT,12921,PESISIR SELATAN,12936,LENGAYANG,16625,7014,23639
12920,SUMATERA BARAT,12921,PESISIR SELATAN,12982,LINGGO SARI BAGANTI,13824,5574,19398
12920,SUMATERA BARAT,12921,PESISIR SELATAN,12990,LUNANG,4741,5076,9817
12920,SUMATERA BARAT,12921,PESISIR SELATAN,12922,PANCUNG SOAL,6917,3211,10128
12920,SUMATERA BARAT,12921,PESISIR SELATAN,83474,RANAH AMPEK HULU TAPAN,4143,1864,6007
12920,SUMATERA BARAT,12921,PESISIR SELATAN,12931,RANAH PESISIR,9987,4188,14175
12920,SUMATERA BARAT,12921,PESISIR SELATAN,83475,SILAUT,3708,3568,7276
12920,SUMATERA BARAT,12921,PESISIR SELATAN,12977,SUTERA,16484,4997,21481
12920,SUMATERA BARAT,13099,SIJUNJUNG,13118,IV NAGARI,6079,924,7003
12920,SUMATERA BARAT,13099,SIJUNJUNG,13124,KAMANG BARU,14311,6826,21137
12920,SUMATERA BARAT,13099,SIJUNJUNG,13143,KOTO VII,11768,3037,14805
12920,SUMATERA BARAT,13099,SIJUNJUNG,13158,KUPITAN,4641,1234,5875
12920,SUMATERA BARAT,13099,SIJUNJUNG,13136,LUBUAK TAROK,4601,2626,7227
12920,SUMATERA BARAT,13099,SIJUNJUNG,13108,SIJUNJUNG,16417,4014,20431
12920,SUMATERA BARAT,13099,SIJUNJUNG,13149,SUMPUR KUDUS,7899,3756,11655
12920,SUMATERA BARAT,13099,SIJUNJUNG,13100,TANJUNG GADANG,8787,1879,10666
12920,SUMATERA BARAT,13010,SOLOK,13039,BUKIT SUNDI,9553,1730,11283
12920,SUMATERA BARAT,13010,SOLOK,13096,DANAU KEMBAR,7174,746,7920
12920,SUMATERA BARAT,13010,SOLOK,13030,GUNUNG TALANG,19944,3412,23356
12920,SUMATERA BARAT,13010,SOLOK,13086,HILIRAN GUMANTI,6056,1149,7205
12920,SUMATERA BARAT,13010,SOLOK,13045,IX KOTO SEI LASI,4366,911,5277
12920,SUMATERA BARAT,13010,SOLOK,13083,JUNJUNG SIRI,5220,738,5958
12920,SUMATERA BARAT,13010,SOLOK,13055,KUBUNG,23290,3836,27126
12920,SUMATERA BARAT,13010,SOLOK,13014,LEMBAH GUMANTI,19286,2441,21727
12920,SUMATERA BARAT,13010,SOLOK,13023,LEMBANG JAYA,10038,1668,11706
12920,SUMATERA BARAT,13010,SOLOK,13011,PANTAI CERMIN,7142,1409,8551
12920,SUMATERA BARAT,13010,SOLOK,13019,PAYUNG SEKAKI,3587,572,4159
12920,SUMATERA BARAT,13010,SOLOK,13090,TIGO LURAH,3878,910,4788
12920,SUMATERA BARAT,13010,SOLOK,13073,X KOTO DIATAS,7811,1579,9390
12920,SUMATERA BARAT,13010,SOLOK,13064,X KOTO SINGKARAK,13797,2730,16527
12920,SUMATERA BARAT,13634,SOLOK SELATAN,13652,KOTO PARIK GADANG DIATEH,7881,2064,9945
12920,SUMATERA BARAT,13634,SOLOK SELATAN,13671,PAUH DUO,6413,1616,8029
12920,SUMATERA BARAT,13634,SOLOK SELATAN,13635,SANGIR,13722,4466,18188
12920,SUMATERA BARAT,13634,SOLOK SELATAN,13676,SANGIR BALAI JANGGO,6212,2771,8983
12920,SUMATERA BARAT,13634,SOLOK SELATAN,13663,SANGIR BATANG HARI,4920,2411,7331
12920,SUMATERA BARAT,13634,SOLOK SELATAN,13657,SANGIR JUJUAN,5340,1078,6418
12920,SUMATERA BARAT,13634,SOLOK SELATAN,13640,SUNGAI PAGU,11577,2697,14274
12920,SUMATERA BARAT,13163,TANAH DATAR,13248,BATIPUAH SELATAN,5057,822,5879
12920,SUMATERA BARAT,13163,TANAH DATAR,13174,BATIPUH,10613,2865,13478
12920,SUMATERA BARAT,13163,TANAH DATAR,13189,LIMA KAUM,15118,3139,18257
12920,SUMATERA BARAT,13163,TANAH DATAR,13200,LINTAU BUO,5338,3689,9027
12920,SUMATERA BARAT,13163,TANAH DATAR,13242,LINTAU BUO UTARA,8652,9698,18350
12920,SUMATERA BARAT,13163,TANAH DATAR,13236,PADANG GANTING,4988,2093,7081
12920,SUMATERA BARAT,13163,TANAH DATAR,13222,PARIANGAN,7683,1711,9394
12920,SUMATERA BARAT,13163,TANAH DATAR,13183,RAMBATAN,13817,2801,16618
12920,SUMATERA BARAT,13163,TANAH DATAR,13229,SALIMPAUANG,8057,1692,9749
12920,SUMATERA BARAT,13163,TANAH DATAR,13211,SUNGAI TARAB,11803,2642,14445
12920,SUMATERA BARAT,13163,TANAH DATAR,13205,SUNGAYANG,6180,2312,8492
12920,SUMATERA BARAT,13163,TANAH DATAR,13239,TANJUANG BARU,5799,948,6747
12920,SUMATERA BARAT,13163,TANAH DATAR,13195,TANJUNG EMAS,9512,2338,11850
12920,SUMATERA BARAT,13163,TANAH DATAR,13164,X KOTO,14816,3437,18253
17404,SUMATERA SELATAN,19172,BANYUASIN,83494,AIR KUMBANG,4359,8278,12637
17404,SUMATERA SELATAN,19172,BANYUASIN,19479,AIR SALEK,5476,13113,18589
17404,SUMATERA SELATAN,19172,BANYUASIN,19173,BANYUASIN I,14114,13552,27666
17404,SUMATERA SELATAN,19172,BANYUASIN,19202,BANYUASIN II,6299,13648,19947
17404,SUMATERA SELATAN,19172,BANYUASIN,19224,BANYUASIN III,19371,14466,33837
17404,SUMATERA SELATAN,19172,BANYUASIN,19293,BETUNG,13961,12304,26265
17404,SUMATERA SELATAN,19172,BANYUASIN,19375,MAKARTI JAYA,5696,8327,14023
17404,SUMATERA SELATAN,19172,BANYUASIN,19336,MUARA PADANG,5059,10856,15915
17404,SUMATERA SELATAN,19172,BANYUASIN,19456,MUARA SUGIHAN,8365,14268,22633
17404,SUMATERA SELATAN,19172,BANYUASIN,19352,MUARA TELANG,8231,12020,20251
17404,SUMATERA SELATAN,19172,BANYUASIN,19263,PULAU RIMAU,7831,14483,22314
17404,SUMATERA SELATAN,19172,BANYUASIN,19315,RAMBUTAN,11080,10913,21993
17404,SUMATERA SELATAN,19172,BANYUASIN,19403,RANTAU BAYUR,11553,10119,21672
17404,SUMATERA SELATAN,19172,BANYUASIN,83430,SEMBAWA,10371,6633,17004
17404,SUMATERA SELATAN,19172,BANYUASIN,83429,SUAK TAPEH,6057,3414,9471
17404,SUMATERA SELATAN,19172,BANYUASIN,83493,SUMBER MARGA TELANG,5701,6002,11703
17404,SUMATERA SELATAN,19172,BANYUASIN,19390,TALANG KELAPA,32924,30737,63661
17404,SUMATERA SELATAN,19172,BANYUASIN,19440,TANJUNG LAGO,7175,12596,19771
17404,SUMATERA SELATAN,19172,BANYUASIN,19425,TUNGKAL ILIR,6315,8380,14695
17404,SUMATERA SELATAN,20345,EMPAT LAWANG,20464,LINTANG KANAN,0,0,0
17404,SUMATERA SELATAN,20345,EMPAT LAWANG,20346,MUARA PINANG,0,0,0
17404,SUMATERA SELATAN,20345,EMPAT LAWANG,20496,PASEMAH AIR KERUH,0,0,0
17404,SUMATERA SELATAN,20345,EMPAT LAWANG,20369,PENDOPO,0,0,0
17404,SUMATERA SELATAN,20345,EMPAT LAWANG,83496,PENDOPO BARAT,0,0,0
17404,SUMATERA SELATAN,20345,EMPAT LAWANG,83495,SALING,0,0,0
17404,SUMATERA SELATAN,20345,EMPAT LAWANG,83431,SIKAP DALAM,0,0,0
17404,SUMATERA SELATAN,20345,EMPAT LAWANG,20482,TALANG PADANG,0,0,0
17404,SUMATERA SELATAN,20345,EMPAT LAWANG,20426,TEBING TINGGI,0,0,0
17404,SUMATERA SELATAN,20345,EMPAT LAWANG,20400,ULU MUSI,0,0,0
17404,SUMATERA SELATAN,20677,KOTA LUBUKLINGGAU,20687,LUBUK LINGGAU BARAT I,9041,6624,15665
17404,SUMATERA SELATAN,20677,KOTA LUBUKLINGGAU,20728,LUBUK LINGGAU BARAT II,6145,5141,11286
17404,SUMATERA SELATAN,20677,KOTA LUBUKLINGGAU,20699,LUBUK LINGGAU SELATAN I,4140,3578,7718
17404,SUMATERA SELATAN,20677,KOTA LUBUKLINGGAU,20737,LUBUK LINGGAU SELATAN II,8213,6481,14694
17404,SUMATERA SELATAN,20677,KOTA LUBUKLINGGAU,20678,LUBUK LINGGAU TIMUR I,9128,5781,14909
17404,SUMATERA SELATAN,20677,KOTA LUBUKLINGGAU,20718,LUBUK LINGGAU TIMUR II,7461,8773,16234
17404,SUMATERA SELATAN,20677,KOTA LUBUKLINGGAU,20707,LUBUK LINGGAU UTARA I,3219,5172,8391
17404,SUMATERA SELATAN,20677,KOTA LUBUKLINGGAU,20747,LUBUK LINGGAU UTARA II,8457,8323,16780
17404,SUMATERA SELATAN,20636,KOTA PAGAR ALAM,20665,DEMPO SELATAN,0,0,0
17404,SUMATERA SELATAN,20636,KOTA PAGAR ALAM,20671,DEMPO TENGAH,3982,3741,7723
17404,SUMATERA SELATAN,20636,KOTA PAGAR ALAM,20657,DEMPO UTARA,0,0,0
17404,SUMATERA SELATAN,20636,KOTA PAGAR ALAM,20648,PAGAR ALAM SELATAN,12743,11880,24623
17404,SUMATERA SELATAN,20636,KOTA PAGAR ALAM,20637,PAGAR ALAM UTARA,10883,9697,20580
17404,SUMATERA SELATAN,20512,KOTA PALEMBANG,20598,BUKIT KECIL,11929,9431,21360
17404,SUMATERA SELATAN,20512,KOTA PALEMBANG,20605,GANDUS,17009,13804,30813
17404,SUMATERA SELATAN,20512,KOTA PALEMBANG,20540,ILIR BARAT I,37846,30192,68038
17404,SUMATERA SELATAN,20512,KOTA PALEMBANG,20513,ILIR BARAT II,0,0,0
17404,SUMATERA SELATAN,20512,KOTA PALEMBANG,20547,ILIR TIMUR I,14921,23998,38919
17404,SUMATERA SELATAN,20512,KOTA PALEMBANG,20559,ILIR TIMUR II,44260,41162,85422
17404,SUMATERA SELATAN,20512,KOTA PALEMBANG,20592,KALIDONI,0,0,0
17404,SUMATERA SELATAN,20512,KOTA PALEMBANG,20585,KEMUNING,22231,20596,42827
17404,SUMATERA SELATAN,20512,KOTA PALEMBANG,20611,KERTAPATI,23192,20737,43929
17404,SUMATERA SELATAN,20512,KOTA PALEMBANG,20618,PLAJU,24482,21746,46228
17404,SUMATERA SELATAN,20512,KOTA PALEMBANG,20580,SAKO,0,0,0
17404,SUMATERA SELATAN,20512,KOTA PALEMBANG,20521,SEBERANG ULU I,43087,40138,83225
17404,SUMATERA SELATAN,20512,KOTA PALEMBANG,20532,SEBERANG ULU II,25990,22029,48019
17404,SUMATERA SELATAN,20512,KOTA PALEMBANG,20631,SEMATANG BORANG,10095,9480,19575
17404,SUMATERA SELATAN,20512,KOTA PALEMBANG,20572,SUKARAMI,37593,36794,74387
17404,SUMATERA SELATAN,20758,KOTA PRABUMULIH,20775,CAMBAI,0,0,0
17404,SUMATERA SELATAN,20758,KOTA PRABUMULIH,20759,PRABUMULIH BARAT,0,0,0
17404,SUMATERA SELATAN,20758,KOTA PRABUMULIH,20797,PRABUMULIH SELATAN,0,0,0
17404,SUMATERA SELATAN,20758,KOTA PRABUMULIH,20766,PRABUMULIH TIMUR,0,0,0
17404,SUMATERA SELATAN,20758,KOTA PRABUMULIH,20791,PRABUMULIH UTARA,0,0,0
17404,SUMATERA SELATAN,20758,KOTA PRABUMULIH,20781,RAMBANG KPK TENGAH,0,0,0
17404,SUMATERA SELATAN,18244,LAHAT,18528,GUMAY TALANG,0,0,0
17404,SUMATERA SELATAN,18244,LAHAT,18599,GUMAY ULU,0,0,0
17404,SUMATERA SELATAN,18244,LAHAT,18260,JARAI,0,0,0
17404,SUMATERA SELATAN,18244,LAHAT,18496,KIKIM BARAT,0,0,0
17404,SUMATERA SELATAN,18244,LAHAT,18434,KIKIM SELATAN,0,0,0
17404,SUMATERA SELATAN,18244,LAHAT,18486,KIKIM TENGAH,0,0,0
17404,SUMATERA SELATAN,18244,LAHAT,18453,KIKIM TIMUR,7048,8516,15564
17404,SUMATERA SELATAN,18244,LAHAT,18282,KOTA AGUNG,0,0,0
17404,SUMATERA SELATAN,18244,LAHAT,18340,LAHAT,0,0,0
17404,SUMATERA SELATAN,18244,LAHAT,18320,MERAPI BARAT,0,0,0
17404,SUMATERA SELATAN,18244,LAHAT,18610,MERAPI SELATAN,0,0,0
17404,SUMATERA SELATAN,18244,LAHAT,18565,MERAPI TIMUR,0,0,0
17404,SUMATERA SELATAN,18244,LAHAT,18635,MUARAPAYANG,0,0,0
17404,SUMATERA SELATAN,18244,LAHAT,18407,MULAK ULU,0,0,0
17404,SUMATERA SELATAN,18244,LAHAT,18544,PAGAR GUNUNG,0,0,0
17404,SUMATERA SELATAN,18244,LAHAT,18376,PAJAR BULAN,0,0,0
17404,SUMATERA SELATAN,18244,LAHAT,18516,PSEKSU,2205,2101,4306
17404,SUMATERA SELATAN,18244,LAHAT,18305,PULAUPINANG,0,0,0
17404,SUMATERA SELATAN,18244,LAHAT,83492,SUKAMERINDU,0,0,0
17404,SUMATERA SELATAN,18244,LAHAT,18580,TANJUNG SAKTI PUMI,0,0,0
17404,SUMATERA SELATAN,18244,LAHAT,18245,TANJUNGSAKTI PUMU,4650,1857,6507
17404,SUMATERA SELATAN,18244,LAHAT,18620,TANJUNGTEBAT,0,0,0
17404,SUMATERA SELATAN,17895,MUARA ENIM,18218,ABAB,0,0,0
17404,SUMATERA SELATAN,17895,MUARA ENIM,83489,BELIMBING,0,0,0
17404,SUMATERA SELATAN,17895,MUARA ENIM,83490,BELINDA DARAT,0,0,0
17404,SUMATERA SELATAN,17895,MUARA ENIM,18211,BENAKAT,0,0,0
17404,SUMATERA SELATAN,17895,MUARA ENIM,18012,GELUMBANG,0,0,0
17404,SUMATERA SELATAN,17895,MUARA ENIM,17967,GUNUNG MEGANG,0,0,0
17404,SUMATERA SELATAN,17895,MUARA ENIM,18227,KELEKAR,0,0,0
17404,SUMATERA SELATAN,17895,MUARA ENIM,18036,LAWANG KIDUL,0,0,0
17404,SUMATERA SELATAN,17895,MUARA ENIM,18176,LEMBAK,0,0,0
17404,SUMATERA SELATAN,17895,MUARA ENIM,18120,LUBAI,0,0,0
17404,SUMATERA SELATAN,17895,MUARA ENIM,83491,LUBAI ULU,0,0,0
17404,SUMATERA SELATAN,17895,MUARA ENIM,18235,MUARA BELIDA,0,0,0
17404,SUMATERA SELATAN,17895,MUARA ENIM,17923,MUARA ENIM,0,0,0
17404,SUMATERA SELATAN,17895,MUARA ENIM,18106,PENUKAL,0,0,0
17404,SUMATERA SELATAN,17895,MUARA ENIM,18197,PENUKAL UTARA,0,0,0
17404,SUMATERA SELATAN,17895,MUARA ENIM,18142,RAMBANG,0,0,0
17404,SUMATERA SELATAN,17895,MUARA ENIM,17940,RAMBANG DANGKU,0,0,0
17404,SUMATERA SELATAN,17895,MUARA ENIM,18044,SEMENDE DARAT LAUT,0,0,0
17404,SUMATERA SELATAN,17895,MUARA ENIM,18055,SEMENDE DARAT TENGAH,0,0,0
17404,SUMATERA SELATAN,17895,MUARA ENIM,18068,SEMENDE DARAT ULU,0,0,0
17404,SUMATERA SELATAN,17895,MUARA ENIM,18156,SUNGAI ROTAN,0,0,0
17404,SUMATERA SELATAN,17895,MUARA ENIM,17991,TALANG UBI,0,0,0
17404,SUMATERA SELATAN,17895,MUARA ENIM,18088,TANAH ABANG,0,0,0
17404,SUMATERA SELATAN,17895,MUARA ENIM,17896,TANJUNG AGUNG,0,0,0
17404,SUMATERA SELATAN,17895,MUARA ENIM,18079,UJAN MAS,0,0,0
17404,SUMATERA SELATAN,18942,MUSI BANYUASIN,83427,BABAT SUPAT,0,0,0
17404,SUMATERA SELATAN,18942,MUSI BANYUASIN,19027,BABAT TOMAN,6874,9482,16356
17404,SUMATERA SELATAN,18942,MUSI BANYUASIN,18992,BATANG HARI LEKO,0,0,0
17404,SUMATERA SELATAN,18942,MUSI BANYUASIN,19095,BAYUNG LENCIR,0,0,0
17404,SUMATERA SELATAN,18942,MUSI BANYUASIN,19081,KELUANG,7653,9078,16731
17404,SUMATERA SELATAN,18942,MUSI BANYUASIN,18958,LAIS,0,0,0
17404,SUMATERA SELATAN,18942,MUSI BANYUASIN,19145,LALAN,0,0,0
17404,SUMATERA SELATAN,18942,MUSI BANYUASIN,83426,LAWANG WETAN,4725,6979,11704
17404,SUMATERA SELATAN,18942,MUSI BANYUASIN,19130,PLAKAT TINGGI,0,0,0
17404,SUMATERA SELATAN,18942,MUSI BANYUASIN,19009,SANGA DESA,0,0,0
17404,SUMATERA SELATAN,18942,MUSI BANYUASIN,18943,SEKAYU,20267,17999,38266
17404,SUMATERA SELATAN,18942,MUSI BANYUASIN,18972,SUNGAI KERUH,0,0,0
17404,SUMATERA SELATAN,18942,MUSI BANYUASIN,19055,SUNGAI LILIN,0,0,0
17404,SUMATERA SELATAN,18942,MUSI BANYUASIN,83425,TUNGKAL JAYA,0,0,0
17404,SUMATERA SELATAN,18643,MUSI RAWAS,18759,JAYALOKA,0,0,0
17404,SUMATERA SELATAN,18643,MUSI RAWAS,18892,KARANG DAPO,0,0,0
17404,SUMATERA SELATAN,18643,MUSI RAWAS,18865,KARANG JAYA,0,0,0
17404,SUMATERA SELATAN,18643,MUSI RAWAS,18812,MEGANG SAKTI,0,0,0
17404,SUMATERA SELATAN,18643,MUSI RAWAS,18772,MUARA BELITI,0,0,0
17404,SUMATERA SELATAN,18643,MUSI RAWAS,18683,MUARA KELINGI,0,0,0
17404,SUMATERA SELATAN,18643,MUSI RAWAS,18662,MUARA LAKITAN,0,0,0
17404,SUMATERA SELATAN,18643,MUSI RAWAS,18880,NIBUNG,0,0,0
17404,SUMATERA SELATAN,18643,MUSI RAWAS,18833,PURWODADI,0,0,0
17404,SUMATERA SELATAN,18643,MUSI RAWAS,18704,RAWAS ILIR,0,0,0
17404,SUMATERA SELATAN,18643,MUSI RAWAS,18716,RAWAS ULU,0,0,0
17404,SUMATERA SELATAN,18643,MUSI RAWAS,18741,RUPIT,0,0,0
17404,SUMATERA SELATAN,18643,MUSI RAWAS,18799,SELANGIT,0,0,0
17404,SUMATERA SELATAN,18643,MUSI RAWAS,18785,STL ULU TERAWAS,0,0,0
17404,SUMATERA SELATAN,18643,MUSI RAWAS,18934,SUKA KARYA,0,0,0
17404,SUMATERA SELATAN,18643,MUSI RAWAS,18912,SUMBER HARTA,0,0,0
17404,SUMATERA SELATAN,18643,MUSI RAWAS,18902,TIANG PUMPUNG KEPUNGUT,0,0,0
17404,SUMATERA SELATAN,18643,MUSI RAWAS,18922,TUAH NEGERI,0,0,0
17404,SUMATERA SELATAN,18643,MUSI RAWAS,18644,TUGUMULYO,0,0,0
17404,SUMATERA SELATAN,18643,MUSI RAWAS,18733,ULU RAWAS,0,0,0
17404,SUMATERA SELATAN,20087,OGAN ILIR,20145,INDRALAYA,10312,8945,19257
17404,SUMATERA SELATAN,20087,OGAN ILIR,20223,INDRALAYA SELATAN,5797,5465,11262
17404,SUMATERA SELATAN,20087,OGAN ILIR,20206,INDRALAYA UTARA,0,0,0
17404,SUMATERA SELATAN,20087,OGAN ILIR,20293,KANDIS,0,0,0
17404,SUMATERA SELATAN,20087,OGAN ILIR,20320,LUBUK KELIAT,0,0,0
17404,SUMATERA SELATAN,20087,OGAN ILIR,20088,MUARA KUANG,0,0,0
17404,SUMATERA SELATAN,20087,OGAN ILIR,20331,PAYARAMAN,0,0,0
17404,SUMATERA SELATAN,20087,OGAN ILIR,20166,PEMULUTAN,0,0,0
17404,SUMATERA SELATAN,20087,OGAN ILIR,20254,PEMULUTAN BARAT,0,0,0
17404,SUMATERA SELATAN,20087,OGAN ILIR,20238,PEMULUTAN SELATAN,0,0,0
17404,SUMATERA SELATAN,20087,OGAN ILIR,20306,RAMBANG KUANG,0,0,0
17404,SUMATERA SELATAN,20087,OGAN ILIR,20192,RANTAU ALAI,0,0,0
17404,SUMATERA SELATAN,20087,OGAN ILIR,20266,RANTAU PANJANG,0,0,0
17404,SUMATERA SELATAN,20087,OGAN ILIR,20279,SUNGAI PINANG,0,0,0
17404,SUMATERA SELATAN,20087,OGAN ILIR,20103,TANJUNG BATU,13131,10764,23895
17404,SUMATERA SELATAN,20087,OGAN ILIR,20125,TANJUNG RAJA,0,0,0
17404,SUMATERA SELATAN,17570,OGAN KOMERING ILIR,17732,AIR SUGIHAN,0,0,0
17404,SUMATERA SELATAN,17570,OGAN KOMERING ILIR,17787,CENGAL,0,0,0
17404,SUMATERA SELATAN,17570,OGAN KOMERING ILIR,17770,JEJAWI,0,0,0
17404,SUMATERA SELATAN,17570,OGAN KOMERING ILIR,17623,KAYU AGUNG,0,0,0
17404,SUMATERA SELATAN,17570,OGAN KOMERING ILIR,17715,LEMPUING,0,0,0
17404,SUMATERA SELATAN,17570,OGAN KOMERING ILIR,17856,LEMPUING JAYA,0,0,0
17404,SUMATERA SELATAN,17570,OGAN KOMERING ILIR,17608,MESUJI,0,0,0
17404,SUMATERA SELATAN,17570,OGAN KOMERING ILIR,17817,MESUJI MAKMUR,0,0,0
17404,SUMATERA SELATAN,17570,OGAN KOMERING ILIR,17838,MESUJI RAYA,0,0,0
17404,SUMATERA SELATAN,17570,OGAN KOMERING ILIR,17693,PAMPANGAN,0,0,0
17404,SUMATERA SELATAN,17570,OGAN KOMERING ILIR,17799,PANGKALAN LAMPAM,0,0,0
17404,SUMATERA SELATAN,17570,OGAN KOMERING ILIR,17593,PEDAMARAN,0,0,0
17404,SUMATERA SELATAN,17570,OGAN KOMERING ILIR,17887,PEDAMARAN TIMUR,0,0,0
17404,SUMATERA SELATAN,17570,OGAN KOMERING ILIR,17649,SIRAH PULAU PADANG,0,0,0
17404,SUMATERA SELATAN,17570,OGAN KOMERING ILIR,17752,SUNGAI MENANG,0,0,0
17404,SUMATERA SELATAN,17570,OGAN KOMERING ILIR,17571,TANJUNG LUBUK,0,0,0
17404,SUMATERA SELATAN,17570,OGAN KOMERING ILIR,17872,TELUK GELAM,0,0,0
17404,SUMATERA SELATAN,17570,OGAN KOMERING ILIR,17670,TULUNG SELAPAN,0,0,0
17404,SUMATERA SELATAN,17405,OGAN KOMERING ULU,17463,BATURAJA BARAT,11318,7105,18423
17404,SUMATERA SELATAN,17405,OGAN KOMERING ULU,17476,BATURAJA TIMUR,30403,16271,46674
17404,SUMATERA SELATAN,17405,OGAN KOMERING ULU,17535,LENGKITI,7282,4320,11602
17404,SUMATERA SELATAN,17405,OGAN KOMERING ULU,17520,LUBUK BATANG,9919,5519,15438
17404,SUMATERA SELATAN,17405,OGAN KOMERING ULU,17564,LUBUK RAJA,10299,6810,17109
17404,SUMATERA SELATAN,17405,OGAN KOMERING ULU,17455,MUARA JAYA,2288,664,2952
17404,SUMATERA SELATAN,17405,OGAN KOMERING ULU,17417,PENGANDONAN,3286,1327,4613
17404,SUMATERA SELATAN,17405,OGAN KOMERING ULU,17430,PENINJAUAN,13074,9287,22361
17404,SUMATERA SELATAN,17405,OGAN KOMERING ULU,17498,SEMIDANG AJI,7504,3824,11328
17404,SUMATERA SELATAN,17405,OGAN KOMERING ULU,17557,SINAR PENINJAUAN,6014,6294,12308
17404,SUMATERA SELATAN,17405,OGAN KOMERING ULU,17406,SOSOH BUAY RAYAP,3951,2281,6232
17404,SUMATERA SELATAN,17405,OGAN KOMERING ULU,17490,ULU OGAN,3309,770,4079
17404,SUMATERA SELATAN,19808,OGAN KOMERING ULU SELATAN,19838,BANDING AGUNG,6327,5185,11512
17404,SUMATERA SELATAN,19808,OGAN KOMERING ULU SELATAN,20057,BUANA PEMACA,3712,2744,6456
17404,SUMATERA SELATAN,19808,OGAN KOMERING ULU SELATAN,19936,BUAY PEMACA,10388,11000,21388
17404,SUMATERA SELATAN,19808,OGAN KOMERING ULU SELATAN,19989,BUAY PEMATANG RIBU RANAU TENGAH,6485,5499,11984
17404,SUMATERA SELATAN,19808,OGAN KOMERING ULU SELATAN,20075,BUAY RAWAN,4132,3158,7290
17404,SUMATERA SELATAN,19808,OGAN KOMERING ULU SELATAN,19905,BUAY RUNJUNG,3940,2317,6257
17404,SUMATERA SELATAN,19808,OGAN KOMERING ULU SELATAN,19888,BUAY SANDANG AJI,5879,3163,9042
17404,SUMATERA SELATAN,19808,OGAN KOMERING ULU SELATAN,19979,KISAM ILIR,2621,1505,4126
17404,SUMATERA SELATAN,19808,OGAN KOMERING ULU SELATAN,19959,KISAM TINGGI,7281,3865,11146
17404,SUMATERA SELATAN,19808,OGAN KOMERING ULU SELATAN,19920,MEKAKAU ILIR,6229,4923,11152
17404,SUMATERA SELATAN,19808,OGAN KOMERING ULU SELATAN,19809,MUARA DUA,0,0,0
17404,SUMATERA SELATAN,19808,OGAN KOMERING ULU SELATAN,19861,MUARA DUA KISAM,6595,2837,9432
17404,SUMATERA SELATAN,19808,OGAN KOMERING ULU SELATAN,19824,PULAU BERINGIN,8505,5917,14422
17404,SUMATERA SELATAN,19808,OGAN KOMERING ULU SELATAN,20029,RUNJUNG AGUNG,4181,2091,6272
17404,SUMATERA SELATAN,19808,OGAN KOMERING ULU SELATAN,19880,SIMPANG,3537,3024,6561
17404,SUMATERA SELATAN,19808,OGAN KOMERING ULU SELATAN,20049,SINDANG DANAU,4075,1615,5690
17404,SUMATERA SELATAN,19808,OGAN KOMERING ULU SELATAN,20039,SUNGAI ARE,3608,2317,5925
17404,SUMATERA SELATAN,19808,OGAN KOMERING ULU SELATAN,20066,TIGA DIHAJI,3396,1930,5326
17404,SUMATERA SELATAN,19808,OGAN KOMERING ULU SELATAN,20012,WARKUK RANAU SELATAN,6058,5819,11877
17404,SUMATERA SELATAN,19492,OGAN KOMERING ULU TIMUR,19528,BELITANG,20440,10959,31399
17404,SUMATERA SELATAN,19492,OGAN KOMERING ULU TIMUR,19629,BELITANG II,11681,13684,25365
17404,SUMATERA SELATAN,19492,OGAN KOMERING ULU TIMUR,19654,BELITANG III,11159,10420,21579
17404,SUMATERA SELATAN,19492,OGAN KOMERING ULU TIMUR,19758,BELITANG JAYA,5685,6716,12401
17404,SUMATERA SELATAN,19492,OGAN KOMERING ULU TIMUR,19772,BELITANG MADANG RAYA,15858,8806,24664
17404,SUMATERA SELATAN,19492,OGAN KOMERING ULU TIMUR,19788,BELITANG MULYA,7336,5088,12424
17404,SUMATERA SELATAN,19492,OGAN KOMERING ULU TIMUR,19510,BUAY MADANG,16800,5633,22433
17404,SUMATERA SELATAN,19492,OGAN KOMERING ULU TIMUR,19684,BUAY MADANG TIMUR,25069,10296,35365
17404,SUMATERA SELATAN,19492,OGAN KOMERING ULU TIMUR,19800,BUAY PEMUKA BANGSA RAJA,5242,1877,7119
17404,SUMATERA SELATAN,19492,OGAN KOMERING ULU TIMUR,19565,BUAY PEMUKA PELIUNG,12516,7643,20159
17404,SUMATERA SELATAN,19492,OGAN KOMERING ULU TIMUR,19675,BUNGA MAYANG,5155,3579,8734
17404,SUMATERA SELATAN,19492,OGAN KOMERING ULU TIMUR,19551,CEMPAKA,8171,5818,13989
17404,SUMATERA SELATAN,19492,OGAN KOMERING ULU TIMUR,19749,JAYAPURA,3653,4309,7962
17404,SUMATERA SELATAN,19492,OGAN KOMERING ULU TIMUR,19596,MADANG SUKU I,12164,8339,20503
17404,SUMATERA SELATAN,19492,OGAN KOMERING ULU TIMUR,19579,MADANG SUKU II,11062,6549,17611
17404,SUMATERA SELATAN,19492,OGAN KOMERING ULU TIMUR,19708,MADANG SUKU III,7916,6924,14840
17404,SUMATERA SELATAN,19492,OGAN KOMERING ULU TIMUR,19493,MARTAPURA,18924,8413,27337
17404,SUMATERA SELATAN,19492,OGAN KOMERING ULU TIMUR,19718,SEMENDAWAI BARAT,6071,4489,10560
17404,SUMATERA SELATAN,19492,OGAN KOMERING ULU TIMUR,19609,SEMENDAWAI SUKU III,11753,10914,22667
17404,SUMATERA SELATAN,19492,OGAN KOMERING ULU TIMUR,19731,SEMENDAWAI TIMUR,8709,11847,20556
6728,SUMATERA UTARA,9497,ASAHAN,9596,AEK KUASAN,4761,7872,12633
6728,SUMATERA UTARA,9497,ASAHAN,9719,AEK LEDONG,3824,6019,9843
6728,SUMATERA UTARA,9497,ASAHAN,9631,AEK SONGSONGAN,3259,5662,8921
6728,SUMATERA UTARA,9497,ASAHAN,9539,AIR BATU,9790,9766,19556
6728,SUMATERA UTARA,9497,ASAHAN,9506,AIR JOMAN,9421,11402,20823
6728,SUMATERA UTARA,9497,ASAHAN,9586,BANDAR PASIR MANDOGE,4857,11593,16450
6728,SUMATERA UTARA,9497,ASAHAN,9565,BANDAR PULAU,4477,6895,11372
6728,SUMATERA UTARA,9497,ASAHAN,9576,BUNTU PANE,4976,7425,12401
6728,SUMATERA UTARA,9497,ASAHAN,9604,KOTA KISARAN BARAT,16480,12068,28548
6728,SUMATERA UTARA,9497,ASAHAN,9618,KOTA KISARAN TIMUR,20541,14396,34937
6728,SUMATERA UTARA,9497,ASAHAN,9498,MERANTI,3218,6662,9880
6728,SUMATERA UTARA,9497,ASAHAN,9552,PULAU RAKYAT,6746,9180,15926
6728,SUMATERA UTARA,9497,ASAHAN,9701,PULO BANDRING,7239,8182,15421
6728,SUMATERA UTARA,9497,ASAHAN,9641,RAHUNING,4415,4765,9180
6728,SUMATERA UTARA,9497,ASAHAN,9693,RAWANG PANCA ARGA,4490,4739,9229
6728,SUMATERA UTARA,9497,ASAHAN,9649,SEI DADAP,7438,7839,15277
6728,SUMATERA UTARA,9497,ASAHAN,9523,SEI KEPAYANG,2956,4231,7187
6728,SUMATERA UTARA,9497,ASAHAN,9660,SEI KEPAYANG BARAT,2862,2225,5087
6728,SUMATERA UTARA,9497,ASAHAN,9667,SEI KEPAYANG TIMUR,2391,1179,3570
6728,SUMATERA UTARA,9497,ASAHAN,9681,SETIA JANJI,2826,3921,6747
6728,SUMATERA UTARA,9497,ASAHAN,9687,SILAU LAUT,4445,5187,9632
6728,SUMATERA UTARA,9497,ASAHAN,9530,SIMPANG EMPAT,7103,10817,17920
6728,SUMATERA UTARA,9497,ASAHAN,9514,TANJUNG BALAI,7629,5422,13051
6728,SUMATERA UTARA,9497,ASAHAN,9712,TELUK DALAM,4211,4397,8608
6728,SUMATERA UTARA,9497,ASAHAN,9673,TINGGI RAJA,4582,5487,10069
6728,SUMATERA UTARA,11635,BATU BARA,11665,AIR PUTIH,11257,12959,24216
6728,SUMATERA UTARA,11635,BATU BARA,11679,LIMA PULUH,18101,22403,40504
6728,SUMATERA UTARA,11635,BATU BARA,11636,MEDANG DERAS,10611,10600,21211
6728,SUMATERA UTARA,11635,BATU BARA,11734,SEI BALAI,6451,7252,13703
6728,SUMATERA UTARA,11635,BATU BARA,11651,SEI SUKA,13961,12921,26882
6728,SUMATERA UTARA,11635,BATU BARA,11707,TALAWI,10748,13683,24431
6728,SUMATERA UTARA,11635,BATU BARA,11721,TANJUNG TIRAM,10275,13665,23940
6728,SUMATERA UTARA,9835,DAIRI,10003,BRAMPU,1314,2208,3522
6728,SUMATERA UTARA,9835,DAIRI,9994,GUNUNG SITEMBER,804,3933,4737
6728,SUMATERA UTARA,9835,DAIRI,9984,LAE PARIRA,1210,5601,6811
6728,SUMATERA UTARA,9835,DAIRI,9972,PARBULUAN,805,8640,9445
6728,SUMATERA UTARA,9835,DAIRI,9958,PEGAGAN HILIR,905,6282,7187
6728,SUMATERA UTARA,9835,DAIRI,9836,SIDIKALANG,5185,17072,22257
6728,SUMATERA UTARA,9835,DAIRI,9883,SIEMPAT NEMPU,1109,7533,8642
6728,SUMATERA UTARA,9835,DAIRI,9947,SIEMPAT NEMPU HILIR,730,4521,5251
6728,SUMATERA UTARA,9835,DAIRI,9934,SIEMPAT NEMPU HULU,2251,6313,8564
6728,SUMATERA UTARA,9835,DAIRI,10009,SILAHISABUNGAN,200,2090,2290
6728,SUMATERA UTARA,9835,DAIRI,9897,SILIMA PUNGGA PUNGA,1240,5235,6475
6728,SUMATERA UTARA,9835,DAIRI,10015,SITINJO,1038,4314,5352
6728,SUMATERA UTARA,9835,DAIRI,9848,SUMBUL,1797,16966,18763
6728,SUMATERA UTARA,9835,DAIRI,9914,TANAH PINEM,1809,9164,10973
6728,SUMATERA UTARA,9835,DAIRI,9868,TIGALINGGA,1728,9860,11588
6728,SUMATERA UTARA,8688,DELI SERDANG,8872,BANGUN PURBA,4991,6222,11213
6728,SUMATERA UTARA,8688,DELI SERDANG,9039,BATANG KUIS,16245,8625,24870
6728,SUMATERA UTARA,8688,DELI SERDANG,9102,BERINGIN,12254,13808,26062
6728,SUMATERA UTARA,8688,DELI SERDANG,8966,DELI TUA,0,0,0
6728,SUMATERA UTARA,8688,DELI SERDANG,8906,GALANG,0,0,0
6728,SUMATERA UTARA,8688,DELI SERDANG,8689,GUNUNG MERIAH,0,0,0
6728,SUMATERA UTARA,8688,DELI SERDANG,8991,HAMPARAN PERAK,44699,23338,68037
6728,SUMATERA UTARA,8688,DELI SERDANG,8760,KUTALIMBARU,0,0,0
6728,SUMATERA UTARA,8688,DELI SERDANG,9012,LABUHAN DELI,0,0,0
6728,SUMATERA UTARA,8688,DELI SERDANG,9051,LUBUK PAKAM,0,0,0
6728,SUMATERA UTARA,8688,DELI SERDANG,8801,NAMORAMBE,0,0,0
6728,SUMATERA UTARA,8688,DELI SERDANG,9065,PAGAR MERBAU,10146,7753,17899
6728,SUMATERA UTARA,8688,DELI SERDANG,8775,PANCUR BATU,14120,24919,39039
6728,SUMATERA UTARA,8688,DELI SERDANG,9082,PANTAI LABU,10445,8143,18588
6728,SUMATERA UTARA,8688,DELI SERDANG,8957,PATUMBAK,0,0,0
6728,SUMATERA UTARA,8688,DELI SERDANG,9018,PERCUT SEI TUAN,91428,62678,154106
6728,SUMATERA UTARA,8688,DELI SERDANG,8729,SIBOLANGIT,0,0,0
6728,SUMATERA UTARA,8688,DELI SERDANG,8856,STM HILIR,4465,10386,14851
6728,SUMATERA UTARA,8688,DELI SERDANG,8936,STM HULU,1225,5003,6228
6728,SUMATERA UTARA,8688,DELI SERDANG,8973,SUNGGAL,0,0,0
6728,SUMATERA UTARA,8688,DELI SERDANG,8702,TANJUNG MORAWA,0,0,0
6728,SUMATERA UTARA,11083,HUMBANG HASUNDUTAN,11119,BAKTIRAJA,208,3339,3547
6728,SUMATERA UTARA,11083,HUMBANG HASUNDUTAN,11162,DOLOK SANGGUL,0,0,0
6728,SUMATERA UTARA,11083,HUMBANG HASUNDUTAN,11139,LINTONG NIHUTA,1419,13138,14557
6728,SUMATERA UTARA,11083,HUMBANG HASUNDUTAN,11203,ONAN GANJANG,496,4531,5027
6728,SUMATERA UTARA,11083,HUMBANG HASUNDUTAN,11216,PAKKAT,0,0,0
6728,SUMATERA UTARA,11083,HUMBANG HASUNDUTAN,11127,PARANGINAN,0,0,0
6728,SUMATERA UTARA,11083,HUMBANG HASUNDUTAN,11084,PARLILITAN,0,0,0
6728,SUMATERA UTARA,11083,HUMBANG HASUNDUTAN,11105,POLLUNG,0,0,0
6728,SUMATERA UTARA,11083,HUMBANG HASUNDUTAN,11192,SIJAMAPOLANG,306,2260,2566
6728,SUMATERA UTARA,11083,HUMBANG HASUNDUTAN,11237,TARABINTANG,0,0,0
6728,SUMATERA UTARA,8408,KARO,8433,BARUSJAHE,1115,10680,11795
6728,SUMATERA UTARA,8408,KARO,8423,BERASTAGI,4211,14167,18378
6728,SUMATERA UTARA,8408,KARO,8637,DOLAT RAYAT,483,3606,4089
6728,SUMATERA UTARA,8408,KARO,8519,JUHAR,651,6993,7644
6728,SUMATERA UTARA,8408,KARO,8409,KABANJAHE,5367,21660,27027
6728,SUMATERA UTARA,8408,KARO,8620,KUTABULUH,1330,5130,6460
6728,SUMATERA UTARA,8408,KARO,8564,LAUBALENG,929,7498,8427
6728,SUMATERA UTARA,8408,KARO,8580,MARDINGDING,735,7003,7738
6728,SUMATERA UTARA,8408,KARO,8645,MERDEKA,1105,5109,6214
6728,SUMATERA UTARA,8408,KARO,8476,MEREK,854,8271,9125
6728,SUMATERA UTARA,8408,KARO,8496,MUNTE,1389,8829,10218
6728,SUMATERA UTARA,8408,KARO,8655,NAMAN TERAN,986,4123,5109
6728,SUMATERA UTARA,8408,KARO,8593,PAYUNG,667,4816,5483
6728,SUMATERA UTARA,8408,KARO,8602,SIMPANG EMPAT,1356,8141,9497
6728,SUMATERA UTARA,8408,KARO,8544,TIGABINANGA,1594,8804,10398
6728,SUMATERA UTARA,8408,KARO,8670,TIGANDERKET,1097,5880,6977
6728,SUMATERA UTARA,8408,KARO,8453,TIGAPANAH,1593,13036,14629
6728,SUMATERA UTARA,12038,KOTA BINJAI,12057,BINJAI BARAT,12530,7522,20052
6728,SUMATERA UTARA,12038,KOTA BINJAI,12049,BINJAI KOTA,8407,7482,15889
6728,SUMATERA UTARA,12038,KOTA BINJAI,12072,BINJAI SELATAN,16054,9154,25208
6728,SUMATERA UTARA,12038,KOTA BINJAI,12064,BINJAI TIMUR,17748,10030,27778
6728,SUMATERA UTARA,12038,KOTA BINJAI,12039,BINJAI UTARA,23149,11275,34424
6728,SUMATERA UTARA,7132,KOTA GUNUNGSITOLI,7133,GUNUNGSITOLI,6030,20577,26607
6728,SUMATERA UTARA,7132,KOTA GUNUNGSITOLI,7230,GUNUNGSITOLI BARAT,313,3331,3644
6728,SUMATERA UTARA,7132,KOTA GUNUNGSITOLI,7193,GUNUNGSITOLI IDANOI,1153,9868,11021
6728,SUMATERA UTARA,7132,KOTA GUNUNGSITOLI,7166,GUNUNGSITOLI SELATAN,535,6019,6554
6728,SUMATERA UTARA,7132,KOTA GUNUNGSITOLI,7182,GUNUNGSITOLI UTARA,1333,6073,7406
6728,SUMATERA UTARA,11743,KOTA MEDAN,11810,MEDAN AMPLAS,33273,20574,53847
6728,SUMATERA UTARA,11743,KOTA MEDAN,11818,MEDAN AREA,32862,22676,55538
6728,SUMATERA UTARA,11743,KOTA MEDAN,11779,MEDAN BARAT,19269,20754,40023
6728,SUMATERA UTARA,11743,KOTA MEDAN,11872,MEDAN BARU,6607,12637,19244
6728,SUMATERA UTARA,11743,KOTA MEDAN,11803,MEDAN BELAWAN,21862,17425,39287
6728,SUMATERA UTARA,11743,KOTA MEDAN,11786,MEDAN DELI,39353,29295,68648
6728,SUMATERA UTARA,11743,KOTA MEDAN,11772,MEDAN DENAI,38688,28462,67150
6728,SUMATERA UTARA,11743,KOTA MEDAN,11764,MEDAN HELVETIA,33517,35254,68771
6728,SUMATERA UTARA,11743,KOTA MEDAN,11831,MEDAN JOHOR,33926,27539,61465
6728,SUMATERA UTARA,11743,KOTA MEDAN,11744,MEDAN KOTA,16439,25773,42212
6728,SUMATERA UTARA,11743,KOTA MEDAN,11844,MEDAN LABUHAN,28948,22552,51500
6728,SUMATERA UTARA,11743,KOTA MEDAN,11859,MEDAN MAIMUN,12801,9913,22714
6728,SUMATERA UTARA,11743,KOTA MEDAN,11838,MEDAN MARELAN,39648,20964,60612
6728,SUMATERA UTARA,11743,KOTA MEDAN,11879,MEDAN PERJUANGAN,25497,24598,50095
6728,SUMATERA UTARA,11743,KOTA MEDAN,11889,MEDAN PETISAH,11954,22355,34309
6728,SUMATERA UTARA,11743,KOTA MEDAN,11866,MEDAN POLONIA,11286,12557,23843
6728,SUMATERA UTARA,11743,KOTA MEDAN,11909,MEDAN SELAYANG,19764,25578,45342
6728,SUMATERA UTARA,11743,KOTA MEDAN,11757,MEDAN SUNGGAL,27470,24877,52347
6728,SUMATERA UTARA,11743,KOTA MEDAN,11851,MEDAN TEMBUNG,36652,26457,63109
6728,SUMATERA UTARA,11743,KOTA MEDAN,11897,MEDAN TIMUR,28108,28932,57040
6728,SUMATERA UTARA,11743,KOTA MEDAN,11793,MEDAN TUNTUNGAN,12319,27223,39542
6728,SUMATERA UTARA,12122,KOTA PADANG SIDIMPUAN,12199,PADANGSIDIMPUAN ANGKOLA JULU,2830,951,3781
6728,SUMATERA UTARA,12122,KOTA PADANG SIDIMPUAN,12153,PADANGSIDIMPUAN BATUNADUA,7548,2276,9824
6728,SUMATERA UTARA,12122,KOTA PADANG SIDIMPUAN,12169,PADANGSIDIMPUAN HUTAIMBARU,6595,1554,8149
6728,SUMATERA UTARA,12122,KOTA PADANG SIDIMPUAN,12140,PADANGSIDIMPUAN SELATAN,20957,8884,29841
6728,SUMATERA UTARA,12122,KOTA PADANG SIDIMPUAN,12180,PADANGSIDIMPUAN TENGGARA,9769,3925,13694
6728,SUMATERA UTARA,12122,KOTA PADANG SIDIMPUAN,12123,PADANGSIDIMPUAN UTARA,24148,5833,29981
6728,SUMATERA UTARA,11916,KOTA PEMATANGSIANTAR,11925,SIANTAR BARAT,10327,9058,19385
6728,SUMATERA UTARA,11916,KOTA PEMATANGSIANTAR,11949,SIANTAR MARIHAT,1689,8070,9759
6728,SUMATERA UTARA,11916,KOTA PEMATANGSIANTAR,11971,SIANTAR MARIMBUN,1284,7142,8426
6728,SUMATERA UTARA,11916,KOTA PEMATANGSIANTAR,11957,SIANTAR MARTOBA,7585,12545,20130
6728,SUMATERA UTARA,11916,KOTA PEMATANGSIANTAR,11942,SIANTAR SELATAN,1181,8265,9446
6728,SUMATERA UTARA,11916,KOTA PEMATANGSIANTAR,11965,SIANTAR SITALASARI,5997,7923,13920
6728,SUMATERA UTARA,11916,KOTA PEMATANGSIANTAR,11917,SIANTAR TIMUR,4159,14493,18652
6728,SUMATERA UTARA,11916,KOTA PEMATANGSIANTAR,11934,SIANTAR UTARA,7902,15791,23693
6728,SUMATERA UTARA,11978,KOTA SIBOLGA,11985,SIBOLGA KOTA,3161,3866,7027
6728,SUMATERA UTARA,11978,KOTA SIBOLGA,11995,SIBOLGA SAMBAS,4169,4129,8298
6728,SUMATERA UTARA,11978,KOTA SIBOLGA,11990,SIBOLGA SELATAN,5701,6600,12301
6728,SUMATERA UTARA,11978,KOTA SIBOLGA,11979,SIBOLGA UTARA,1651,7978,9629
6728,SUMATERA UTARA,12000,KOTA TANJUNG BALAI,12026,DATUK BANDAR,6436,6972,13408
6728,SUMATERA UTARA,12000,KOTA TANJUNG BALAI,12032,DATUK BANDAR TIMUR,7560,4126,11686
6728,SUMATERA UTARA,12000,KOTA TANJUNG BALAI,12014,SEI TUALANG RASO,5044,3642,8686
6728,SUMATERA UTARA,12000,KOTA TANJUNG BALAI,12001,TANJUNG BALAI SELATAN,3993,5131,9124
6728,SUMATERA UTARA,12000,KOTA TANJUNG BALAI,12008,TANJUNG BALAI UTARA,3523,3551,7074
6728,SUMATERA UTARA,12000,KOTA TANJUNG BALAI,12020,TELUK NIBUNG,7963,5189,13152
6728,SUMATERA UTARA,12081,KOTA TEBING TINGGI,12106,BAJENIS,8963,7862,16825
6728,SUMATERA UTARA,12081,KOTA TEBING TINGGI,12098,PADANG HILIR,9204,6888,16092
6728,SUMATERA UTARA,12081,KOTA TEBING TINGGI,12082,PADANG HULU,8165,6273,14438
6728,SUMATERA UTARA,12081,KOTA TEBING TINGGI,12090,RAMBUTAN,9399,7137,16536
6728,SUMATERA UTARA,12081,KOTA TEBING TINGGI,12114,TEBING TINGGI KOTA,5861,7338,13199
6728,SUMATERA UTARA,9727,LABUHANBATU,9749,BILAH BARAT,10276,6125,16401
6728,SUMATERA UTARA,9727,LABUHANBATU,9760,BILAH HILIR,10740,13104,23844
6728,SUMATERA UTARA,9727,LABUHANBATU,9774,BILAH HULU,15414,13143,28557
6728,SUMATERA UTARA,9727,LABUHANBATU,9818,PANAI HILIR,6461,7671,14132
6728,SUMATERA UTARA,9727,LABUHANBATU,9827,PANAI HULU,7452,7769,15221
6728,SUMATERA UTARA,9727,LABUHANBATU,9807,PANAI TENGAH,5368,8405,13773
6728,SUMATERA UTARA,9727,LABUHANBATU,9799,PANGKATAN,7165,9523,16688
6728,SUMATERA UTARA,9727,LABUHANBATU,9739,RANTAU SELATAN,19295,9890,29185
6728,SUMATERA UTARA,9727,LABUHANBATU,9728,RANTAU UTARA,24400,16271,40671
6728,SUMATERA UTARA,6729,LABUHANBATU SELATAN,6741,KAMPUNG RAKYAT,12712,14141,26853
6728,SUMATERA UTARA,6729,LABUHANBATU SELATAN,6730,KOTAPINANG,14894,13122,28016
6728,SUMATERA UTARA,6729,LABUHANBATU SELATAN,6782,SILANGKITANG,6988,9008,15996
6728,SUMATERA UTARA,6729,LABUHANBATU SELATAN,6772,SUNGAI KANAN,14780,7798,22578
6728,SUMATERA UTARA,6729,LABUHANBATU SELATAN,6757,TORGAMBA,17524,29511,47035
6728,SUMATERA UTARA,6789,LABUHANBATU UTARA,6820,AEK KUO,5583,9640,15223
6728,SUMATERA UTARA,6789,LABUHANBATU UTARA,6862,AEK NATAS,7817,7835,15652
6728,SUMATERA UTARA,6789,LABUHANBATU UTARA,6812,KUALUH HILIR,4649,9288,13937
6728,SUMATERA UTARA,6789,LABUHANBATU UTARA,6790,KUALUH HULU,11924,21298,33222
6728,SUMATERA UTARA,6789,LABUHANBATU UTARA,6804,KUALUH LEIDONG,5008,8122,13130
6728,SUMATERA UTARA,6789,LABUHANBATU UTARA,6875,KUALUH SELATAN,11146,18706,29852
6728,SUMATERA UTARA,6789,LABUHANBATU UTARA,6829,MARBAU,11432,9894,21326
6728,SUMATERA UTARA,8094,LANGKAT,8302,BABALAN,12053,12274,24327
6728,SUMATERA UTARA,8094,LANGKAT,8095,BAHOROK,0,0,0
6728,SUMATERA UTARA,8094,LANGKAT,8358,BATANG SERANGAN,0,0,0
6728,SUMATERA UTARA,8094,LANGKAT,8323,BESITANG,0,0,0
6728,SUMATERA UTARA,8094,LANGKAT,8168,BINJAI,13548,8475,22023
6728,SUMATERA UTARA,8094,LANGKAT,8350,BRANDAN BARAT,0,0,0
6728,SUMATERA UTARA,8094,LANGKAT,8289,GEBANG,10299,9860,20159
6728,SUMATERA UTARA,8094,LANGKAT,8240,HINAI,0,0,0
6728,SUMATERA UTARA,8094,LANGKAT,8133,KUALA,11025,9508,20533
6728,SUMATERA UTARA,8094,LANGKAT,8387,KUTAMBARU,2173,4877,7050
6728,SUMATERA UTARA,8094,LANGKAT,8274,PADANG TUALANG,11242,12489,23731
6728,SUMATERA UTARA,8094,LANGKAT,8311,PANGKALAN SUSU,0,0,0
6728,SUMATERA UTARA,8094,LANGKAT,8398,PEMATANG JAYA,0,0,0
6728,SUMATERA UTARA,8094,LANGKAT,8115,SALAPIAN,5536,8311,13847
6728,SUMATERA UTARA,8094,LANGKAT,8368,SAWIT SEBERANG,5258,7260,12518
6728,SUMATERA UTARA,8094,LANGKAT,8220,SECANGGANG,17900,14641,32541
6728,SUMATERA UTARA,8094,LANGKAT,8151,SEI BINGEI,8473,14775,23248
6728,SUMATERA UTARA,8094,LANGKAT,8334,SEI LEPAN,9688,12619,22307
6728,SUMATERA UTARA,8094,LANGKAT,8176,SELESAI,0,0,0
6728,SUMATERA UTARA,8094,LANGKAT,8376,SIRAPIT,4312,4443,8755
6728,SUMATERA UTARA,8094,LANGKAT,8191,STABAT,0,0,0
6728,SUMATERA UTARA,8094,LANGKAT,8254,TANJUNG PURA,0,0,0
6728,SUMATERA UTARA,8094,LANGKAT,8204,WAMPU,11793,9067,20860
6728,SUMATERA UTARA,10227,MANDAILING NATAL,10505,BATAHAN,7227,2751,9978
6728,SUMATERA UTARA,10227,MANDAILING NATAL,10453,BATANG NATAL,9102,2683,11785
6728,SUMATERA UTARA,10227,MANDAILING NATAL,10343,BUKIT MALINTANG,3906,1343,5249
6728,SUMATERA UTARA,10227,MANDAILING NATAL,10588,HUTA BARGOT,3140,626,3766
6728,SUMATERA UTARA,10227,MANDAILING NATAL,10355,KOTANOPAN,10802,1950,12752
6728,SUMATERA UTARA,10227,MANDAILING NATAL,10392,LEMBAH SORIK MARAPI,4566,637,5203
6728,SUMATERA UTARA,10227,MANDAILING NATAL,10485,LINGGA BAYU,6986,4178,11164
6728,SUMATERA UTARA,10227,MANDAILING NATAL,10554,MUARA BATANG GADIS,4479,2393,6872
6728,SUMATERA UTARA,10227,MANDAILING NATAL,10437,MUARA SIPONGI,3410,1666,5076
6728,SUMATERA UTARA,10227,MANDAILING NATAL,10638,NAGA JUANG,845,1062,1907
6728,SUMATERA UTARA,10227,MANDAILING NATAL,10524,NATAL,8616,5370,13986
6728,SUMATERA UTARA,10227,MANDAILING NATAL,10614,PAKANTAN,725,370,1095
6728,SUMATERA UTARA,10227,MANDAILING NATAL,10308,PANYABUNGAN BARAT,4153,683,4836
6728,SUMATERA UTARA,10227,MANDAILING NATAL,10228,PANYABUNGAN KOTA,29000,5814,34814
6728,SUMATERA UTARA,10227,MANDAILING NATAL,10296,PANYABUNGAN SELATAN,4475,656,5131
6728,SUMATERA UTARA,10227,MANDAILING NATAL,10280,PANYABUNGAN TIMUR,5181,805,5986
6728,SUMATERA UTARA,10227,MANDAILING NATAL,10267,PANYABUNGAN UTARA,6169,2550,8719
6728,SUMATERA UTARA,10227,MANDAILING NATAL,10602,PUNCAK SORIK MARAPI,3985,299,4284
6728,SUMATERA UTARA,10227,MANDAILING NATAL,10569,RANTO BAEK,4376,1664,6040
6728,SUMATERA UTARA,10227,MANDAILING NATAL,10319,SIABU,16900,4237,21137
6728,SUMATERA UTARA,10227,MANDAILING NATAL,10623,SINUNUKAN,4297,4290,8587
6728,SUMATERA UTARA,10227,MANDAILING NATAL,10402,TAMBANGAN,5476,837,6313
6728,SUMATERA UTARA,10227,MANDAILING NATAL,10423,ULU PUNGKUT,2232,182,2414
6728,SUMATERA UTARA,7960,NIAS,8020,BAWOLATO,1524,7707,9231
6728,SUMATERA UTARA,7960,NIAS,8069,BOTOMUZOI,387,3819,4206
6728,SUMATERA UTARA,7960,NIAS,7975,GIDO,517,8501,9018
6728,SUMATERA UTARA,7960,NIAS,7961,HILIDUHO,222,4117,4339
6728,SUMATERA UTARA,7960,NIAS,8056,HILISERANGKAI,427,5891,6318
6728,SUMATERA UTARA,7960,NIAS,8001,IDANO GAWO,2099,9244,11343
6728,SUMATERA UTARA,7960,NIAS,8082,ULUGAWO,486,4785,5271
6728,SUMATERA UTARA,7013,NIAS BARAT,7014,LAHOMI,616,4002,4618
6728,SUMATERA UTARA,7013,NIAS BARAT,7112,LOLOFITU MOI,1197,4315,5512
6728,SUMATERA UTARA,7013,NIAS BARAT,7078,MANDREHE,700,8860,9560
6728,SUMATERA UTARA,7013,NIAS BARAT,7052,MANDREHE BARAT,243,2714,2957
6728,SUMATERA UTARA,7013,NIAS BARAT,7099,MANDREHE UTARA,406,3086,3492
6728,SUMATERA UTARA,7013,NIAS BARAT,7026,SIROMBU,1121,3396,4517
6728,SUMATERA UTARA,10646,NIAS SELATAN,10823,AMANDRAYA,1376,3881,5257
6728,SUMATERA UTARA,10646,NIAS SELATAN,10963,ARAMO,0,0,0
6728,SUMATERA UTARA,10646,NIAS SELATAN,83467,BORONADU,0,0,0
6728,SUMATERA UTARA,10646,NIAS SELATAN,11005,FANAYAMA,0,0,0
6728,SUMATERA UTARA,10646,NIAS SELATAN,10674,GOMO,0,0,0
6728,SUMATERA UTARA,10646,NIAS SELATAN,10735,HIBALA,0,0,0
6728,SUMATERA UTARA,10646,NIAS SELATAN,10917,HILIMEGAI,0,0,0
6728,SUMATERA UTARA,10646,NIAS SELATAN,83460,HURUNA,0,0,0
6728,SUMATERA UTARA,10646,NIAS SELATAN,10699,LAHUSA,952,10935,11887
6728,SUMATERA UTARA,10646,NIAS SELATAN,10647,LOLOMATUA,0,0,0
6728,SUMATERA UTARA,10646,NIAS SELATAN,10902,MANIAMOLO,0,0,0
6728,SUMATERA UTARA,10646,NIAS SELATAN,10941,MAZINO,1391,5820,7211
6728,SUMATERA UTARA,10646,NIAS SELATAN,10990,MAZO,851,6331,7182
6728,SUMATERA UTARA,10646,NIAS SELATAN,83462,ONOHAZUMBA,0,0,0
6728,SUMATERA UTARA,10646,NIAS SELATAN,83468,SIMUK,0,0,0
6728,SUMATERA UTARA,10646,NIAS SELATAN,83466,SOMAMBAWA,529,4392,4921
6728,SUMATERA UTARA,10646,NIAS SELATAN,10887,SUSUA,0,0,0
6728,SUMATERA UTARA,10646,NIAS SELATAN,83471,TANAH MASA,0,0,0
6728,SUMATERA UTARA,10646,NIAS SELATAN,10805,TELUK DALAM,1587,16952,18539
6728,SUMATERA UTARA,10646,NIAS SELATAN,10929,TOMA,0,0,0
6728,SUMATERA UTARA,10646,NIAS SELATAN,83459,ULUNOYO,0,0,0
6728,SUMATERA UTARA,10646,NIAS SELATAN,83464,ULUSUSUA,1720,5107,6827
6728,SUMATERA UTARA,10646,NIAS SELATAN,10953,UMBUNASI,0,0,0
6728,SUMATERA UTARA,6888,NIAS UTARA,6973,AFULU,1024,3083,4107
6728,SUMATERA UTARA,6888,NIAS UTARA,6949,ALASA,964,5926,6890
6728,SUMATERA UTARA,6888,NIAS UTARA,6942,ALASA TALUMUZOI,303,2070,2373
6728,SUMATERA UTARA,6888,NIAS UTARA,6983,LAHEWA,1884,6709,8593
6728,SUMATERA UTARA,6888,NIAS UTARA,7005,LAHEWA TIMUR,421,3031,3452
6728,SUMATERA UTARA,6888,NIAS UTARA,6889,LOTU,508,4498,5006
6728,SUMATERA UTARA,6888,NIAS UTARA,6930,NAMOHALU ESIWA,346,4987,5333
6728,SUMATERA UTARA,6888,NIAS UTARA,6903,SAWO,639,3293,3932
6728,SUMATERA UTARA,6888,NIAS UTARA,6923,SITOLU ORI,523,4696,5219
6728,SUMATERA UTARA,6888,NIAS UTARA,6964,TUGALA OYO,202,2890,3092
6728,SUMATERA UTARA,6888,NIAS UTARA,6914,TUHEMBERUA,469,4122,4591
6728,SUMATERA UTARA,12606,PADANG LAWAS,83407,AEK NABARA BARUMUN,4731,939,5670
6728,SUMATERA UTARA,12606,PADANG LAWAS,12809,BARUMUN,15495,4218,19713
6728,SUMATERA UTARA,12606,PADANG LAWAS,83406,BARUMUN SELATAN,2990,710,3700
6728,SUMATERA UTARA,12606,PADANG LAWAS,12630,BARUMUN TENGAH,7043,1296,8339
6728,SUMATERA UTARA,12606,PADANG LAWAS,12891,BATANG LUBU SUTAM,4142,1598,5740
6728,SUMATERA UTARA,12606,PADANG LAWAS,12708,HURISTAK,5480,2539,8019
6728,SUMATERA UTARA,12606,PADANG LAWAS,12761,HUTA RAJA TINGGI,10019,8416,18435
6728,SUMATERA UTARA,12606,PADANG LAWAS,12736,LUBUK BARUMUN,6099,1660,7759
6728,SUMATERA UTARA,12606,PADANG LAWAS,83472,SIHAPAS BARUMUN,2188,432,2620
6728,SUMATERA UTARA,12606,PADANG LAWAS,12851,SOSA,10863,3981,14844
6728,SUMATERA UTARA,12606,PADANG LAWAS,12607,SOSOPAN,3501,1262,4763
6728,SUMATERA UTARA,12606,PADANG LAWAS,12793,ULU BARUMUN,4212,1738,5950
6728,SUMATERA UTARA,12208,PADANG LAWAS UTARA,12527,BATANG ONANG,4184,1640,5824
6728,SUMATERA UTARA,12208,PADANG LAWAS UTARA,12254,DOLOK,9196,2746,11942
6728,SUMATERA UTARA,12208,PADANG LAWAS UTARA,12209,DOLOK SIGOMPULON,5245,2407,7652
6728,SUMATERA UTARA,12208,PADANG LAWAS UTARA,12341,HALONGONAN,10677,5694,16371
6728,SUMATERA UTARA,12208,PADANG LAWAS UTARA,12595,HULU SIHAPAS,1693,382,2075
6728,SUMATERA UTARA,12208,PADANG LAWAS UTARA,12386,PADANG BOLAK,24707,6380,31087
6728,SUMATERA UTARA,12208,PADANG LAWAS UTARA,12464,PADANG BOLAK JULU,3887,1054,4941
6728,SUMATERA UTARA,12208,PADANG LAWAS UTARA,12488,PORTIBI,10348,1955,12303
6728,SUMATERA UTARA,12208,PADANG LAWAS UTARA,12560,SIMANGAMBAT,12475,13490,25965
6728,SUMATERA UTARA,11022,PAKPAK BHARAT,11034,KERAJAAN,1262,2414,3676
6728,SUMATERA UTARA,11022,PAKPAK BHARAT,11064,PAGINDAR,207,346,553
6728,SUMATERA UTARA,11022,PAKPAK BHARAT,11058,PERGETTENG GETTENG SENGKUT,780,971,1751
6728,SUMATERA UTARA,11022,PAKPAK BHARAT,11045,SALAK,855,2621,3476
6728,SUMATERA UTARA,11022,PAKPAK BHARAT,11076,SIEMPAT RUBE,414,1486,1900
6728,SUMATERA UTARA,11022,PAKPAK BHARAT,11023,SITELU TALI URANG JEHE,2143,1729,3872
6728,SUMATERA UTARA,11022,PAKPAK BHARAT,11052,SITELU TALI URANG JULU,599,1122,1721
6728,SUMATERA UTARA,11022,PAKPAK BHARAT,11069,TINADA,421,1386,1807
6728,SUMATERA UTARA,11247,SAMOSIR,11260,HARIAN,363,3524,3887
6728,SUMATERA UTARA,11247,SAMOSIR,11292,NAINGGOLAN,297,5292,5589
6728,SUMATERA UTARA,11247,SAMOSIR,11279,ONAN RUNGGU,261,4752,5013
6728,SUMATERA UTARA,11247,SAMOSIR,11305,PALIPI,358,7874,8232
6728,SUMATERA UTARA,11247,SAMOSIR,11328,PANGURURAN,966,13704,14670
6728,SUMATERA UTARA,11247,SAMOSIR,11319,RONGGUR NIHUTA,267,3605,3872
6728,SUMATERA UTARA,11247,SAMOSIR,11248,SIANJUR MULA MULA,215,4468,4683
6728,SUMATERA UTARA,11247,SAMOSIR,11357,SIMANINDO,479,10367,10846
6728,SUMATERA UTARA,11374,SERDANG BEDAGAI,11457,BANDAR KHALIFAH,4193,7930,12123
6728,SUMATERA UTARA,11374,SERDANG BEDAGAI,11615,BINTANG BAYU,3783,2781,6564
6728,SUMATERA UTARA,11374,SERDANG BEDAGAI,11502,DOLOK MASIHUL,13599,12301,25900
6728,SUMATERA UTARA,11374,SERDANG BEDAGAI,11463,DOLOK MERAWAN,5940,3684,9624
6728,SUMATERA UTARA,11374,SERDANG BEDAGAI,11531,KOTARIH,1591,2761,4352
6728,SUMATERA UTARA,11374,SERDANG BEDAGAI,11375,PANTAI CERMIN,11276,9103,20379
6728,SUMATERA UTARA,11374,SERDANG BEDAGAI,11579,PEGAJAHAN,5846,8612,14458
6728,SUMATERA UTARA,11374,SERDANG BEDAGAI,11388,PERBAUNGAN,28203,21630,49833
6728,SUMATERA UTARA,11374,SERDANG BEDAGAI,11593,SEI BAMBAN,7063,13952,21015
6728,SUMATERA UTARA,11374,SERDANG BEDAGAI,11553,SERBA JADI,4518,5707,10225
6728,SUMATERA UTARA,11374,SERDANG BEDAGAI,11543,SILINDA,1158,3375,4533
6728,SUMATERA UTARA,11374,SERDANG BEDAGAI,11481,SIPISPIS,7929,8827,16756
6728,SUMATERA UTARA,11374,SERDANG BEDAGAI,11448,TANJUNG BERINGIN,7955,7942,15897
6728,SUMATERA UTARA,11374,SERDANG BEDAGAI,11604,TEBING SYAHBANDAR,10468,5890,16358
6728,SUMATERA UTARA,11374,SERDANG BEDAGAI,11564,TEBING TINGGI,12524,9286,21810
6728,SUMATERA UTARA,11374,SERDANG BEDAGAI,11417,TELUK MENGKUDU,9692,9765,19457
6728,SUMATERA UTARA,9114,SIMALUNGUN,9382,BANDAR,13056,16782,29838
6728,SUMATERA UTARA,9114,SIMALUNGUN,9372,BANDAR HULUAN,6467,6922,13389
6728,SUMATERA UTARA,9114,SIMALUNGUN,9397,BANDAR MASILAM,6559,5814,12373
6728,SUMATERA UTARA,9114,SIMALUNGUN,9204,BOSAR MALIGAS,8701,11264,19965
6728,SUMATERA UTARA,9114,SIMALUNGUN,9310,DOLOK BATU NANGGAR,11047,10255,21302
6728,SUMATERA UTARA,9114,SIMALUNGUN,9276,DOLOK PANRIBUAN,865,8446,9311
6728,SUMATERA UTARA,9114,SIMALUNGUN,9349,DOLOK PARDAMEAN,515,7822,8337
6728,SUMATERA UTARA,9114,SIMALUNGUN,9414,DOLOK SILAU,850,6301,7151
6728,SUMATERA UTARA,9114,SIMALUNGUN,9304,GIRSANG SIPANGAN BOLON,860,7009,7869
6728,SUMATERA UTARA,9114,SIMALUNGUN,9133,GUNUNG MALELA,8780,9304,18084
6728,SUMATERA UTARA,9114,SIMALUNGUN,9150,GUNUNG MALIGAS,7665,5511,13176
6728,SUMATERA UTARA,9114,SIMALUNGUN,9298,HARANGGAOL HORISON,222,2690,2912
6728,SUMATERA UTARA,9114,SIMALUNGUN,9266,HATONDUHAN,2079,8167,10246
6728,SUMATERA UTARA,9114,SIMALUNGUN,9326,HUTA BAYU RAJA,3696,10975,14671
6728,SUMATERA UTARA,9114,SIMALUNGUN,9340,JAWA MARAJA BAH JAMBI,4883,5400,10283
6728,SUMATERA UTARA,9114,SIMALUNGUN,9182,JORLANG HATARAN,1949,6265,8214
6728,SUMATERA UTARA,9114,SIMALUNGUN,9488,PAMATANG SILIMA HUTA,323,5053,5376
6728,SUMATERA UTARA,9114,SIMALUNGUN,9160,PANEI,2220,9457,11677
6728,SUMATERA UTARA,9114,SIMALUNGUN,9172,PANOMBEIAN PANE,3068,7582,10650
6728,SUMATERA UTARA,9114,SIMALUNGUN,9360,PEMATANG BANDAR,6474,9134,15608
6728,SUMATERA UTARA,9114,SIMALUNGUN,9234,PEMATANG SIDAMANIK,1896,6648,8544
6728,SUMATERA UTARA,9114,SIMALUNGUN,9287,PURBA,1039,9521,10560
6728,SUMATERA UTARA,9114,SIMALUNGUN,9452,RAYA,2199,13824,16023
6728,SUMATERA UTARA,9114,SIMALUNGUN,9192,RAYA KAHEAN,2269,6713,8982
6728,SUMATERA UTARA,9114,SIMALUNGUN,9115,SIANTAR,12917,19726,32643
6728,SUMATERA UTARA,9114,SIMALUNGUN,9220,SIDAMANIK,3902,10164,14066
6728,SUMATERA UTARA,9114,SIMALUNGUN,9407,SILIMAKUTA,626,5254,5880
6728,SUMATERA UTARA,9114,SIMALUNGUN,9424,SILOU KAHEAN,2095,6009,8104
6728,SUMATERA UTARA,9114,SIMALUNGUN,9245,TANAH JAWA,8933,16027,24960
6728,SUMATERA UTARA,9114,SIMALUNGUN,9441,TAPIAN DOLOK,9783,10642,20425
6728,SUMATERA UTARA,9114,SIMALUNGUN,9470,UJUNG PADANG,8424,11708,20132
6728,SUMATERA UTARA,7697,TAPANULI SELATAN,7908,AEK BILAH,2908,975,3883
6728,SUMATERA UTARA,7697,TAPANULI SELATAN,7698,ANGKOLA BARAT,8823,2362,11185
6728,SUMATERA UTARA,7697,TAPANULI SELATAN,7949,ANGKOLA SANGKUNUR,3871,5876,9747
6728,SUMATERA UTARA,7697,TAPANULI SELATAN,7809,ANGKOLA SELATAN,5712,6129,11841
6728,SUMATERA UTARA,7697,TAPANULI SELATAN,7737,ANGKOLA TIMUR,8052,1963,10015
6728,SUMATERA UTARA,7697,TAPANULI SELATAN,7864,ARSE,2975,1570,4545
6728,SUMATERA UTARA,7697,TAPANULI SELATAN,7827,BATANG ANGKOLA,11997,3672,15669
6728,SUMATERA UTARA,7697,TAPANULI SELATAN,7713,BATANG TORU,7160,7530,14690
6728,SUMATERA UTARA,7697,TAPANULI SELATAN,7875,MARANCAR,3491,1451,4942
6728,SUMATERA UTARA,7697,TAPANULI SELATAN,7921,MUARA BATANG TORU,2141,2946,5087
6728,SUMATERA UTARA,7697,TAPANULI SELATAN,7794,SAIPAR DOLOK HOLE,4687,2178,6865
6728,SUMATERA UTARA,7697,TAPANULI SELATAN,7888,SAYUR MATINGGI,7994,3401,11395
6728,SUMATERA UTARA,7697,TAPANULI SELATAN,7753,SIPIROK,11369,4333,15702
6728,SUMATERA UTARA,7697,TAPANULI SELATAN,7931,TANO TOMBANGAN ANGKOLA,1431,6247,7678
6728,SUMATERA UTARA,7240,TAPANULI TENGAH,7361,ANDAM DEWI,1407,4863,6270
6728,SUMATERA UTARA,7240,TAPANULI TENGAH,7392,BADIRI,2631,6471,9102
6728,SUMATERA UTARA,7240,TAPANULI TENGAH,7241,BARUS,3972,2833,6805
6728,SUMATERA UTARA,7240,TAPANULI TENGAH,7411,BARUS UTARA,240,2040,2280
6728,SUMATERA UTARA,7240,TAPANULI TENGAH,7299,KOLANG,1291,6367,7658
6728,SUMATERA UTARA,7240,TAPANULI TENGAH,7425,LUMUT,992,3857,4849
6728,SUMATERA UTARA,7240,TAPANULI TENGAH,7289,MANDUAMAS,1828,5877,7705
6728,SUMATERA UTARA,7240,TAPANULI TENGAH,7271,PANDAN,0,0,0
6728,SUMATERA UTARA,7240,TAPANULI TENGAH,7402,PASARIBU TOBING,0,0,0
6728,SUMATERA UTARA,7240,TAPANULI TENGAH,7281,PINANGSORI,2315,6550,8865
6728,SUMATERA UTARA,7240,TAPANULI TENGAH,7432,SARUDIK,0,0,0
6728,SUMATERA UTARA,7240,TAPANULI TENGAH,7322,SIBABANGUN,2050,5479,7529
6728,SUMATERA UTARA,7240,TAPANULI TENGAH,7352,SIRANDORUNG,1010,4761,5771
6728,SUMATERA UTARA,7240,TAPANULI TENGAH,7376,SITAHUIS,0,0,0
6728,SUMATERA UTARA,7240,TAPANULI TENGAH,7255,SORKAM,0,0,0
6728,SUMATERA UTARA,7240,TAPANULI TENGAH,7340,SORKAM BARAT,2183,4574,6757
6728,SUMATERA UTARA,7240,TAPANULI TENGAH,7330,SOSOR GADONG,0,0,0
6728,SUMATERA UTARA,7240,TAPANULI TENGAH,7418,SUKA BANGUN,340,1114,1454
6728,SUMATERA UTARA,7240,TAPANULI TENGAH,7312,TAPIAN NAULI,2000,6211,8211
6728,SUMATERA UTARA,7240,TAPANULI TENGAH,7383,TUKKA,1587,3496,5083
6728,SUMATERA UTARA,7438,TAPANULI UTARA,7484,ADIAN KOTING,518,5878,6396
6728,SUMATERA UTARA,7438,TAPANULI UTARA,7668,GAROGA,914,6395,7309
6728,SUMATERA UTARA,7438,TAPANULI UTARA,7681,MUARA,229,6506,6735
6728,SUMATERA UTARA,7438,TAPANULI UTARA,7591,PAGARAN,308,7648,7956
6728,SUMATERA UTARA,7438,TAPANULI UTARA,7534,PAHAE JAE,821,4304,5125
6728,SUMATERA UTARA,7438,TAPANULI UTARA,7514,PAHAE JULU,586,5306,5892
6728,SUMATERA UTARA,7438,TAPANULI UTARA,7645,PANGARIBUAN,929,11370,12299
6728,SUMATERA UTARA,7438,TAPANULI UTARA,7606,PARMONANGAN,303,6447,6750
6728,SUMATERA UTARA,7438,TAPANULI UTARA,7557,PURBA TUA,482,2920,3402
6728,SUMATERA UTARA,7438,TAPANULI UTARA,7471,SIATAS BARITA,664,5661,6325
6728,SUMATERA UTARA,7438,TAPANULI UTARA,7548,SIMANGUMBAN,677,2716,3393
6728,SUMATERA UTARA,7438,TAPANULI UTARA,7621,SIPAHUTAR,706,10962,11668
6728,SUMATERA UTARA,7438,TAPANULI UTARA,7499,SIPOHOLON,936,9178,10114
6728,SUMATERA UTARA,7438,TAPANULI UTARA,7439,TARUTUNG,2140,16837,18977
6728,SUMATERA UTARA,10020,TOBA SAMOSIR,10147,AJIBATA,191,3686,3877
6728,SUMATERA UTARA,10020,TOBA SAMOSIR,10021,BALIGE,1692,16619,18311
6728,SUMATERA UTARA,10020,TOBA SAMOSIR,83408,BONATUA LUNASI,279,2402,2681
6728,SUMATERA UTARA,10020,TOBA SAMOSIR,10113,BORBOR,208,3139,3347
6728,SUMATERA UTARA,10020,TOBA SAMOSIR,10091,HABINSARAN,636,6951,7587
6728,SUMATERA UTARA,10020,TOBA SAMOSIR,10055,LAGUBOTI,781,9000,9781
6728,SUMATERA UTARA,10020,TOBA SAMOSIR,10157,LUMBAN JULU,242,3990,4232
6728,SUMATERA UTARA,10020,TOBA SAMOSIR,10200,NASSAU,617,3259,3876
6728,SUMATERA UTARA,10020,TOBA SAMOSIR,83409,PARMAKSIAN,762,4203,4965
6728,SUMATERA UTARA,10020,TOBA SAMOSIR,10102,PINTU POHAN MERANTI,574,2485,3059
6728,SUMATERA UTARA,10020,TOBA SAMOSIR,10120,PORSEA,758,5734,6492
6728,SUMATERA UTARA,10020,TOBA SAMOSIR,10213,SIANTAR NARUMONDA,300,2563,2863
6728,SUMATERA UTARA,10020,TOBA SAMOSIR,10191,SIGUMPAR,269,3368,3637
6728,SUMATERA UTARA,10020,TOBA SAMOSIR,10076,SILAEN,414,6305,6719
6728,SUMATERA UTARA,10020,TOBA SAMOSIR,10206,TAMPAHAN,134,1971,2105
6728,SUMATERA UTARA,10020,TOBA SAMOSIR,10173,ULUAN,297,3850,4147
